█████████████████████████████████ ██████████████████████████████████████████████████████████  ██████████████████████████
████    ████████████████████████  ██████████████████  ███████████████████████████████████    ████████████████████  █████
███      ███    ████████████████  ████████████   ██     ████████████████████    ███████      ███████         ███    ████
███              █████     ████    ██████████               ███████  ███████      ███        ██████           ██        
████                        ██     ███  ███                ███████    ██████                  █████           ███      █
█████                      ███                     ███    ███████     ████████                  ████          ███     ██
██████                     ███                █    ███   ████████      ████████                  ███           ██     ██
███████                    ███               ███    ███  ████████       ████████                 ████                 ██
███████                     ███             ████     ████████████          █████                 █████               ███
███████        ██           ████           ████       ███████████           ████                 ██████    ██       ████
██████        ████          █████  ███    ████         ███████████           ████                 ████████████      ████
████          ████         ████████████   ████    █    ████████████          ██████               ███████████       ████
███           █████   ██   ████████████   ███    ██    █████████████         █████████             █████████        ████
██             █████████   ████████████   ███     █   ██████████████         ██████████    ██        ██████        █████
█                ███████   █████████████  ███         █████████████    █     ██████████    ██         ████         █████
                  ████     █████████████  ████       ███  ██   █████  ██      ███ █████    ██         ████         █████
                          ████  ████████  █████     ███    █    ████████           ███                ███           ████
█                        ████    ██████  ███████     █     ██    ███████           ██          ██                    ███
█                        ███      █████  ███████          ████    ███████         ███         ████                   ███
█                                 ████   ██████           ████      █████        ███          ████              ██   ███
█                                 ████    █████           █████       ███        ██           ████             █████████
██          ██                    ███      ███           █████████                            ████             █████████
██         █████                            █            ██████████                          ████              █████████
██        ████████                                       ██████████                       ███████              █████████
██   ██   █████████                                       █████████                       ███████    █        ██████████
██   ██   █████████                                       ██████████                      ███████   ███       ██████████
██   ██   █████████                                  ███  ██████████                        █████   ███      ███████████
██   ██    ████████             ██████               ██████████████                           █████████      ███████████
█          ████████    ██      ██████████            ██████████                        █       ████████      ███████████
█           ████████  ████     ███████████     ███    ████████                        ███       ██████       ███████████
██          ████████  █████     ██████████    █████      █████                  █     ███       █████        ███████████
███        ████  ██    ████     ██████████    ████████   ██████                ███   ████       ████         ████   ████
████    ██████          ████    ██████████    █████████████████                 █    ████        ██           ██     ███
██████████████          ████    ███████████  ████    ██████████                      ████                            ███
███████  ██████          ██      ███████████████      █████████                       ███                            ███
██████    █████████              ███████████████       ████████   █                    █                             ███
██         █████████              ██████████████         ██████                ███                                   ███
█           ████████                      ██████    █     █████               █████                                  ███
█           █████  ██                        ██    ███    █████              ██████                    █████         ███
█           ████    █████                          ███   ██████  ██         ███████     █             ███████        ███
██           ██     █████                          ███   ███████████████    ███        ███            ███████        ███
███                  ████                          ███    ███████████████              ███           ███████         ███
████                                               ███    ███████████████               █            ████            ███
████                                               ████  █████████████████                            ███            ███
█████                                              ████████████████████████                            ██            ███
█████              ████                   ██       ████████████████  ███████                   ███     ███            ██
█████             ██████                 ███████    ██████████████    ██████                   ██████   ████          ██
████              ████████              █████████    ████████████      ████             ███    ███████ ██████         ██
███                ████████            █████████     ███████████                       ████   ███████████████        ███
██                    █████            ██████         ██████████                       ███    ████  ██████████      ████
█                      ███              ████             ███████    ████              ███      ██    ██████████    █████
█                      ███               ██    ███████    ███████  ██████             ███             ██   ████    █████
█                     ███                     █████████   ███████████████            ████                   ██      ████
█                     ███                    ██████████   ██████████████             ████                   ██       ███
█                     ████████               ██████████  ██████████████              ████             ██   ████      ███
██                    █████████        ██   █████   ██  ███████████████              ███              ███  ████      ███
██                    ██████████      █████████         ████████████████             ███  ███  ███   ████   ███     ████
██      ████    ██   ████████████    █████████         ████████████████████████     ███████████████  █████  ████   █████
███  █████████████████████████████████████████   ███████████████████████████████  ████████████████████████  ████████████
███████████████████████████████████████████████ ███████████████████████████████████████████████████████████ ████████████
█████████████████████████████████  ██████████████████████████████████████████████████████████ ██████████████████████████
███████████████   ███████████████      ██████████████████████                                                          █
███████            ███████████████      ██████████   ████████                                                          █
██                  ████████████████      ██████     ██████ █                                                           
██                  ██████████████████      ███      █████  █                                                          █
███                  ████     █████████      ██     █████  ██                                                          █
███                            █████████     ███    ███   ███                                                          █
██                             █████████     ████         ███                                                          █
██                             █████████     ████         ███                                                          █
███       ████                ███████████    ████         ███                                                          █
███      ██████    ██        █████████████    ███        ████                                                          █
███     ████████  ████      ██████   █████    ███        ████                                                          █
███      █████████████      ██████     ███               ████                                                          █
██       ████████████        █████                ██     ████                                                          █
█        ████████████        █████               ████   █████                                                          █
         ███████████        █████              ██████   ████                                                           █
         ██████████         ████              ████████  █████                                                          █
█        █████              ███       ███     ████████  █████                                                          █
██        ████              ██       █████    ███████   █████                                                          █
██         ███                      ██████     ████     █████                                                          █
██         ███                    ████████               ████                                                          █
██          █                    ████████                ████                                                          █
██                               ████████         ██      ███                                                          █
██                              ██████████       ████     ███                                                          █
██                    ██   ████████████████      ████    ████                                                          █
███                  ██████████████████████████   ██     ████                                                          █
███                  ███████  ██████████████████         ████                                                          █
███                  ██████    █████    █████████        ████                                                          █
██████                ██       ████      ████████       █████                                                          █
███████                         ███          █████     ██████                                                          █
███████                          ███           ███    ███████                                                          █
███████                           ███           █     ███████                                                          █
███████                            █                 ████████                                                          █
███████                                     █        ████████                                                          █
██████        ██                 ██        ███       ████████                                                          █
█████         ███               ████                 ████████                                                          █
████           ███              ████                  ███████                                                          █
███            █████            ████                     ████                                                          █
██             ██████            ██                       ███                                                          █
██     ███     ███████                                     ██                                                          █
█     █████     ██████                         ██          ██                                                          █
█    ██████      █████                       ████         ███                                                          █
██    ████        ████             ███      █████         ███                                                          █
██                 ███            █████    ██████         ███                                                          █
██          ██      █     ████    █████    ███████         ██                                                          █
██         ███          ███████    █████    ███████        ██                                                          █
██          ██         █████████     ███      █████        ██                                                          █
██                     █████████      ███      ███        ███                                                          █
██                     ████           ████                ███                                                          █
█                      ████           ████               ████                                                          █
█                      ████            ██                ████                                                          █
█                      ████                              ████                                                          █
█                       ██       █                       ████                                                          █
██             ██               ███                       ███                                                          █
███            ████             ███            ██         ███                                                          █
███   ████       ███            ███            ██        ████                                                          █
███  ██████       ███           ████     ██    ██      ██████                                                          █
███  ███████      ████          █████   █████   ██    ███████                                                          █
████████████████████████       ███████████████  ███  ████████                                                          █
███████████████████████████████████████████████ ███████████████████████████████████████████████████████████ ████████████
