████████████████████████████████████████████████████████████████████████████████████████████████████████████████████████████████████████████████████████████████████████████████████████████████████████████████████████████████████████████████████████████████████████████████████████
██ ██  █   ██    █  █ ██      █   ██ █ ███ ██  ██ █  █      █ ██       █ █  ██   █ ██   █    █ █    █ █    ██  █  █   █ ██      █    █     █      █  █   ███ ███  ██    █ █  █  █  ████        █ ██ █  █    ███     █  ██ ██ █ ██  ███ ███ █ █  █   █ ████  █ █ ██   █        █ █    ███
█    █ ██████  █  █ █ █  ███         █ ██  ██  ████    ███ █  █  █    █ ██  █   ██ ███  ██   ██ ██  ██  ██████████            ███ █  ███  ██ █  ██ ██ █      █ █ █ ██    █ █ █ ████   ██  ███        ████ ████ █      █  ██  ███ ██ █      █ █   █  █ ███  █   █   █    █  █  █   █  █ █
█ ██████ ██ ███    █  █ ███    █ █ ██   █  █ ██     ████ ██████  █   ███ ██  █ █     █ █  █  █    ██    █  ██ █ ██ ██   ██ █ █  ██  █ █ ███ ████ █   █   █ █ █████  ██   ██ ██ █   █  ██  ███  █  ██ █    █    ███  ███ ████      █ █  █  ███  ██   ██ █ █          ██  █ ██ ████   █ ██
█ ██   ██    ██ ███ ███  ████  ████ █ ███       ████  █ █    █ ██████ █       ██ ████  ██  ██   ███ ███ █ █ ██   ███ █ █ ██ █ █ █         ███ █  ████ █  █  █ ██ █   ███ █ █  █   █  ████   ██ ██ █ █████  ██ ██ ██     █   ██ █ █ ███  ██  ██  █ ███ █ █  ██ █   ██  ██ ███████   █ █ █
█ ██   █    █    ██  ██ ███ ██  █ █ ███ ███   ███ █   ██  █  █  ██      ██████              █  ███ ████ ██    ████████  █ ██ █    █ █   █ █ ███ █   █  █    █ ███     █ █ ███ █ █ █ ██ █████  █   █ █ █     ███ ██  █ ███  █   █  █  ███ ██ █ ██ ███   █ ██      ███  ██  █  █   ██    █
███    █   ██  █     █ █   ███  ██ █ █    ██  ███ █     █ █ █   █  █ █  █   █  █  ████ ██ ██  █████  ██ █ ██ █ █ ██    █       █        █   █   ██ ██   █  █ █   ███ █   ███ █  █  ██   █ █     ██  █    █ █  ██ █ ██  ██ ███     █  ███ ██  █   █ █    ██           ██ ██████   █   ███
██      █  ██ █    █    ██   ██ █ █    ██ █   ███  ████ ███ █ █  ██     █ █  █    █ ██ █  █  ██   █    █  █  █ █ ██ ██ █       █ █ ███  █  █ █ █ ██   ███   ████  █ █ █ ████ ███ █ ███ ██    █ ██ ██ ███ █ █   █ █ █    ██ █ █   ██ ███ █ █ █  █ █ ██ █  ██████  ███ █ ███  █   █ █   ██
█ █  █ ██  █████ ███ ██ █  ██       ██      ██  ██  ████ █     ████ ██    ████    █  █  ████████ █ █  █ █  █ █  █ █ █ ████ ████     ███  █ ██ ███   ████ ████  █  ██ ██    ███  █ ██   █   █    █ █   ███       █   █████ ██  █     █  ██ █ █ ████ █ ██     █  █     ██ ██  ██  █ ████ █
█       █  █   ██   █  █ █ █  █ █ ███  ███  █  ██  █  █ ██████ ██ ██ ████ ██           █    █ ██  █     █ ███ █  ███   ███   █ █     ██ █ ██  ██  █ █   ██ █ ███  █ █████    █████ █ ████  █    ██ ██  ███  █    ██ █ ██ █    █ █    ███ ██ █         ███ █    █████ █   ██ █ █      █ █
██ ██ █    ██  █  ██  ██████  ███ ███  ██   ████ ███   █ █  █    ██        ███ █  ████ █ █ █  ██ ███          ███      ███   ██  ██     ██████ ████ █ ████   █  █    ██ ██████     █  █ ███     █ █     █  █ ██ █    █  █   █  █ █   █      █    █ █  ███ ███  ██ █ █        █  █ █ ████
█      █          ████ █  ██  █  ██      █  ██ ██ ████ █ █ █   ██     ██ █  █ ██   █   █  █     █    ███  █  █ █   ██████  █ █ █   █ ██     ██   ██ █ ██  █  █ █ █   █    █  ██ █  █  ███   ███   █ █ █     ██ ███  █  █████ ██  █  █        █   █  █ ██ ███ █ █  █  ███ █  █   █ █  █ █
██   ██   ███     ███  ██ █  ██ █ ████ ████  █ █   ██    ██         █ ████  ██  ███ █ █  █ █████  ███ █  ██ ██ ████ ███ █ ██     ██       ██ ████ █ █ █████ █ █ █ █ █  █ █     █    █ █     █   █   █  ██████  █   █ █    █  █   ██       █ █     ██     ██ ███ █ █  ██  ██████   ██ █ █
█   █  ███   █    ███████ ████  ████   ██  █████   ████  ██  ████  █    █  █ ████ █  ███ █  ██ █    █   ███ █ ███ █ █  ██       ████   ███   █    ██       ██    ██   ██    ███ █ █ ██        ███ ██    █     █ ██ ██   █   █  ██ ██       █ ██   █ █  █ ██     ████  █  █ ████ ███  █ █
█     ███  █  █     █  ██  █   █      ██ ██  █      █   ██ ███     █   ██   █ █ █ █  ██ ████   ██  █ █        █     █ █   ████ █ ███   ███ ██    █████ ███ ███ █ █ █ █  █  █ █████   █     ██  █ █ █ █ ██   ██ █ █  █  ████   ██  █  █  █ █ █ █████        ███  █ █ █ █████    ██   █  █
█   █ █  ██ █   █     █  ██ █  ███ █   ██ ████   █ █  █   ██ █  █ ██     ████    ██ █  ███     ████     █ █ ██     █  ███ ██ █  █    ██ █   ███ ██    ███   █ █  ██         ███   ██████  ████ █ ███   ██   █  █  ███    ███     █         ███       ██  ███  ██    █   █ █ █   ██     █
█ █  █   █ █ █   █ ███   ██  █ ███   ██ █ █  █ █ █ █ █   █ █ █████ ████ ████  ██ ██  ████ ████     █   █  ██  █ █ ███ ██   █████ ███   █   █  ███ █     █  █████ █ █ ██ █    ██     █ █████ ███ █ █ █ █ ██   ██ ██ █    ██  ██  ███   ██ ██  █ █     █ ████████  █ █   █ ███  ██  █ █ ██
██    █ █████  ██ █ ██  █ █████ ██   █ ██  █ ██  ██   ██ ██  █  ██   █   ██ █    █   ███ █ █  █ █   █   ██ █ █ █   ██ ██    ██   █ █ ███ ███ █   █  █  █ ██     ██  ██  █  █ █ ███   ███ ██ ██  █ █ ███    █   ██   ██  ████  █ ██    ██ ███ ██ █  █   █     █ ██ ███   █      ███  █ ██
█ █ ██    ███ ███ ██    ███ ██  █  ███  ██   ███ █    ████  █ █ █ ██   █  ███  █    ██  ███ ███   █ █    ██ ███   ███    ██  █   █  ███    █  █  █     █  █   █████   ██    █ ██  ███ ██ █   █ █ █ ██     █ █    ████    █   ██ █     █  ██   ██    █ █ █  ███   ██ █ █ █  ███   ██ ██ █
████  ██     ██   ██ █  █   █      ██   █   ████ █  ██    █   ██  ██ █  ███ █   █ █     █     █ █ █ █ █ █ ████    █ █ ██    █  █  ██ █████    █ █    █    █ ███  ██  █  ██  █████ █       █  ██   █   ██        █   ██    ██     █ █ █  █████  █████    █  █   █  ███ █     █    █  ██ █
█ █   █  ████ █ █  ██ ███   █   ██  █ █ █ █ ███   ████   █  ██ ██  █ ██    █  ███ █    ██ █ █ █ ███   █ █ █ ██ █ ██ █  █      █  █ ████ ██    █   █ ██ ██████ ██ █ ██ █ ██ ██ ██   █  ███ █████ ██  █     █ █ ██  █ █  █     ██      █   █ █      █ ████  █     █  █   █ █     ████ █ ██
█  ███ █  █  █  █  ████   █████  █    █████     ████    █ ████ ████ █     █  ████ ███ █       █   █ █ █  █ █  █ █  █ ██ █   █ █             ███ █ █  ███ ██  ██████ ██ █   ███   ███  █    ███    ██   █ █ ███ ███  █ █      ██ █ ██ █       █     █    ████ ██    █    █    ███ █   █ █
█   █ ███     █ ███   ██   ██     █ ███  █ ████ ██  ██  █ ██  ██████  ██       ██ ████      █   █  █    ██  █ █   ███   █ ██  ██  █ █    █ █ ████ █ █  █  █ █ █    █  █ ██   ██    ███ █      ███  ████  ███   █   █ █ █  ██   █      ███            █ ████   █    █████ ██  ████ ██   █
█  ██    █ ██  ██ ██        █ ██ █  ████      ██ ██   ████   ██ █  ██ █  ██  ████ █ █  █ █ █    ██     █ █ █  ████  █ ██   █  ███  █    █  █  ██ ██████ █ ███  ███ █ ██        ██  ██ ███      █████       ████████ █    █    ██   █ █ █ █    █ ███████ ██  ██ █ ██ █ ███   ██    ██   █
██ █ ███      ██ ██ █       █ █   ██ ██  █ █      ██    █ █████   █ ██   ███ █ ██ █    █   █ █  ██   █ ██   █ ██    █ ██ ████   ████   █ █  ████   █ █ ██  █ █      █   ████ ██   ███  ██  █  ██ ███  █ █    █  ███   ██    █████  █████  █ █ ██        ██   █    ███ █     █ █  ████  █
█ █ ██  █ ██  █  █  █ █  █ █ █████  █   █ ████    █ █ █ █ ██ ███  ██████    ██  █    █   ██ █ █   █ ██ ██  ████  ███ ██   █ █     ████    █ ███ █    █    ███  █    █   ██ ██ █ █  █         █ █ █ █ ██  █ █  ██   █ ███    ██    █ █  ██ █████   █    █ ██ ████    ███ ██ █ ███  █ █ ██
█      ███  █ █  █  ███ █ ██  ██  █ █ ██  █    █ █ ███ ███       ███ ██  █ █ █    ████  █ █ █  ██  █    ██ ██  █ ██       ██  █ ███   ██  ███  █  █        ████   ██ ██  █ █ ██  █  █     ██ █    ████    ██          ██ █   █   ██ ████   █ ███ ██ █ █  █ ███  ███      ███   █  █  █ █
██ ████ █   █ ██ █   █  ██   █  █  █ █████  █ █     █   █ ███████ ████  █   █  █  █  █ █  █          █ ██    █ ██ █     █ █      ██   █  ███ ██     █  ██ █  ████    █████       ███ ██ ████   ██ █ ██  ████    █  █   ██████  █████ █ █    ██ ███  █       █    █ █ ██ █ █   ██ █ ██ ██
███   █  █  █ █ █    █    █      ██   ███  ██         █ █ █       ████  █ █  █ ██  █   █ ███  ███  █  ███ ███     ██  █   █████████ █ █ █  ████ █████     ███ █  █ █ ███  █ █ █  ██████        █ ██   █  ███ █ ██ █   ██████  ██  ██      █   █ █  █  █ ████ █████ █ █  █ ███   █ █ ████
█████ █   ███   ██   █ █ ███        █    █ ██  █  █ ██  █        █████ █      ███    ██  █ ██ █ █ ██ ████    █ ██ █      ██   ████ █      ████  ██  █ █   █ █  █ █  █ █   █  █    █   █  █ ███ █████  ███ █ █  ███ ██ ██  ██ ██ █   █  █  █  █████ █████    █ ██ █     ██ █ ██ █  █    █
██ █████  █   █ ██  ██  █ █  █ █  ██   █████ ███ █ ██   █  ███ █   ██ █   █ █  █ █ ██   ██      ██ ████ ███  ██ ██   ██ █ █   █  █ █   ██    █ ███  ███ ███   ██ █     █  ██      ████  █     ██ █  █   █ █       ███  █ ███ ██████   █   █  █   █ █   ██    ██     █ █ ██    ██  █  ███
██   ███  ██ ██  █       █     █  ██  █ █       █ █ █  ██    ████   ████     ██ ██  █  █   ██   ███  █ █ █     █     █ ██          █ █ █ █████    █  █      █   █   ██   ██  █  ███  █  ██ ██  ██ ██  ███ █ ██   ██   ██   ███  █████ █   █ ██       █  ████    ███ ██ █ ██████ ███ █  █
█   █ █   █    █   ███      █ █ ███ ██ █ ██     █ ████ ███  █ █  █    ████      ██ ███     █     █   ██████  ██  █      █ █  ██ █  ██ █    █████████   █  █       █  █  █████████ ██ ███    ████     █   ██  ██   █   ██ █   ███  █      ███ █ ███   ████    █ ███  ███  █  ██    █   ██
███ █ █ █ ███ █  █   █   █ █ █  ██    ██ ██ ████ █ ██  █ █  █ ██ █  █  █ █ ██     ██ █ ████  █  █ ███ █ █  ███ █ ██ ███ █  █ █ █   ██ ██       █  █     █   ██ ██████ █ █       █   █ █   ██ █  ██ █  ██ █ ██ ███     █  ██   ██████   █ ███ ██    ████ ██ █  ███████ █            █  ██
█████ █   █      ██     █    ██  ██    ██    █ █  █    █████  ██ █   ██ ██ █ ██ ████  █ █ ████   █ █ █ ████ █  █        █    █ █  █    █  █████ █  ███  ███ █  ██  ███  ████  ██ ██ █  █  ██ █  ██ █   ██  █ ███ ███     ██    █ ██ █  ██ █ █ █ █ ██ ██   █████ ██ █     █ ██ █  █  █ ██
█  █  ████    ████  █    ██ █  █ ███ ██   █ ██ ██ ███ ███  ██  ██  █      █ ██ █   █  ██ █  █ █ ████  ███ ████ █       ██  █ █  █  ███   ██ ████ █     █   █  █   █  ███ █  ████ ████ ██  █   ███ ████ █  █ █ ███  █ █ ██  ████        █ █  █ █   █ █ █ █  ███ █       █    █ ██     ███
█ ██  ██ █ ██ ██  █   ████ ██   █  ██ ██ ██   ██ █   ████ ██ █      █████   █ ██  █ ██ █  ███  █  ████ █    █ █   ██    ██████   ███   █ ████ █     ████      █ █ █ █  ██   ██  ██    ██ █   ██ █      ██      ██   ███ █ ██  ███ ███ ████   █ █  █ ██ ███   █ █     █ ██████ █ ████  ██
██  █  ██    █    █   ██████   ███ ████ ██ █ ██ █ █     ██  ██     █   ███████  █ ███ █ █ ███ █      ██  ████ ██████    ██  █      ██  █ ███   █ █  █   █ ███ ██  ██ ██    █   █ █   █ █  ███        █    ██   █ ██ █ █   █ █   █ █  ███████  █  █  █ █    █     ████  █    █  █ ██ █  █
████ █ █ ██  █   ██       █  █ ██     ██ █ █  █████ ██  ██ █  █   █  ██ █ █ █ ██   █ ██ ██  █ █  █      ████████  █  █ ██ █ █  █  █  █  █ █  █  █ ███  ███     █    ██ ███   ██ █ ████ █  █ █ ██ ██ █ █  █ █ ██  █████████ ███   █   █   █   █      █ ██  ████  █ █ █       █    ████  █
██ ███ ██ ██ █   █ █ █     █  █    █ █     ██ █ █  ██ ██ █ █       ████  █  █ ███   █   ███ ████     █ █ ████  █  █   █ █ ██ ██  ██      ████    █  █████  ██  █    ██  █   ████  █ █    █  ███    ██ █   █  █  █ █ █    ██   █   ███ █ ███    █   █    ██      ███  ███  ██ █   █ █████
██ █  █    █ █     █  ██ █ █ █  █    █ █ █████ ███ █     █ █ █      █ █ █ █        █ █  ██   ███      ██ █ ██ ███ █    ███████    ████ █  █ █  █████  █ █  █ █ █████  ██  ███████  █████    █  █ ██  █   █  ██ █  ███  █ ███ █    ███ ██  █ ███████ ██ ██ █  █████  █      █ ██ █ ██  ██
███ █ █      █  ██    ██   ██     ███ █  ███ █ █ ██         █   █  █ ████  ██  ██ █  ██   █ █ ████ ██████ ███  █   █  █   ███  █ █  █     ██ █ ███  █   ████ █ ██  █    █ █    ██ ███ ██  █  █     █  █ █               █  █      █ █ █ ██  █  █    ██ █ █ ██████  ███ █ ██ ██  ██ █   █
██  ██     █   ████  ██ █ █  ███  █  ███     ██ █  ███ ██ █ █████ ██     ███████ ██ █  ██ █    █ █      █  ██      █ █ ██  █    █  █ █  ███   █ █  ██  █  ██ ██████  █ █  █    ██  ████   █  █     █████     ██ ██    █    ████       █ █     ██   ██ █        ██  █ █ █ █ █████  █  ███
██ █ █    ███  █  ██  █ ██ ██  █  ███ ██ █ ██ ██ ██ █  █ █     █ █   █  █ █   █ █ █ █   ██ █ █ ██    ███ █ ███ █      █ ██ ██   ███       ██████ █ █     █ ███   ██  █ █  ██  ██ ██ █   █  ██ █   ██  █   ██ █████   ██  █ █ ███   █  █   ██    █   █  █      ██  █  █  █   █ █ ███   ██
████     ████      █   █ █ ███████     ██  █ █ █   █ █    █ ████ █ █ ██  █ ██ ██    █       ████    █ █  █  ██████  ███ █ ██ █   ███    █    █          █     █ █     ██████    █  ████ ███ █  ██  █      ██   ██  █ █ ██    ██ █  ██   █ █ █  █ █    █ ████   ██ ███   ███    ████ ██ █
███ █    █ █ █ █ █  █     █   █    █     ██ █  █  █  █  ██  █ █ █   ███ █  █  █ ████   █ █ █  █  ██ █ ███ ██ █   █ █ ██   ██   ██  ████ ██   ██    █  █ █  █ ██ ███ █  █ ███ █ ██     ██  █  █ ███        █  █ ███   █ █ █ ███    █ █  █ █   █      █ █      ██████  ███ ███      █    █
█  ██ ███  █ █ █   ██ █  ██  █ ██ ███ ███ ██ ███      ████ █  ██   █  █  █  ██ █  █ ██ ████  ████   ██    ██     ███ █ ██ ███    █ █       █████ █   █     █ ███ █ █    █████ █ ██████  █ █ █ █   ██     █   █ █ ███  █ █████  █      █ █  █  ███   ███  ████  ████  █ █  ██    ██   █ █
█     █   █ █ █      █  █ ███ ██ █   █     █████  ██     ████    ████    █ █ █ █      █   █  █   █   ████ ████ ██  ███  █    █     █  █████ █  █      █  ██ █ █    ████ █ █ █  █  ██            ██  ██ █  █  ██      █ █████   █     ██ ███ █  █        █ ██ █ ██     ██ █ █ ████ █  █ █
█ █ █ █ █ ████ ██   █    █      █  █ ████    ██ ██  █ █ ████ ███   ██ ███     ██   █ █ █ █ █    █   ███ ████    ███ ██ █  █ █   █   █ █ ██ █     ███  █  ██ ███ █ ██ ██   █  ████ ██  ████ █ █ ██    ██  █ █   █ █ ██ ██  ██ █    ██  █ █ ███    ███ █    ██  █ ██ █████   █ █ █ ██ █ ██
████  █ ███   █    █     ██████ █ █    █     █ █ ████  █ ██  █ ██ █     █     █ ██    █ ███  █  █   ██ ██ █  █ ████ █ ██ ██ █  █ ██ █ █  █ ██   ██ █   █ █  █ █ ██  █   █ █ ███     █████   ██   ██ █ ██     ██ █  █  ███ █████     █ ██ ████████ ████  ██    █ █  ████ █  █ █       ███
█    █  █ █  █ █    ██████ █ █   ██ ██ ██    █████   █  █ █  ██ ██ ████   █ █  █ ██  ██      █  █   █  ██   ██ █ ██      █ █       ██  ███    █ ██ █       ███ █    █████ ████ █ ██ ██  ██  █  █  █ █ █████ █  █ █ █    █  ██ █      ██ █████ ██   █   ██  █  █  █     ███  ██ █ ███   █
█  █   █  █       ██████  ███    ██ █   ██        █      █   █ ███ █ █  █ █ ██ ██ █   █ ██    ███ █ █ █   ████  ██ █    █ ███  ███ █   ██  █  █  ██ ██  █ █ ███   █  ██         █  ██   ██   ███████  ███ █ ███ ███      ██████ █  █ █  ██████ ██ ██ █   █ ██ █  █████  █ █ █  █ ██ █  █
█ ███   ██   █  █  █   ███   █ █  █ █ ██ █  █   ███  ██████    █ █ ███ ███  █  █  █  ███  ████  █ █████  ██ ██     █ █ ██   ███ ██   ██  █ █    █ ██   █      ████          ██  █  █████   ███   ██  ██    ██ █  ██ █ █   █ █ █ ████ █ ███ ███  █      ███ █ ███ ██    █ ██    █     █ █
██ █   █   ██ █    ████ █ ████  █ ██ ███  ██ █ ███   █ █ █    █ ██ ███ █ ████████ █   █   ███    █ █ ██ █   ██  █     █ █ █ ██   █    █      █        █    ███ ███ █  ███      ██ ██   ███████ █ █   █  ████ █   ███ ██ █     █   ██  █████    █ ██ ███ ███ █  ██  █  ████████ ██    █ █
█  █   ██ █   ██   █ ██████ ██  ██ █ ██   █  ██  ██ ███   █     █  █   ██ █   █    ██  ██████  █ █    ██    █ █ █ █  ████  █  █ ██   ███      █    █   ██ ██             ███    █ █       ██ ██   █ █       █      ███ ██   ███ █ █   ███  █    ██  █ █ █  █ █  █   ██ ██   █ ███ █  ███
██ ██   █ █    ██   █  █    ██  ███ █ █   █ ██  █    █  █             █    █    ██ ██ █    ██████  ██  ██    ██    ██ ██  █     ███   ██  █ ██    ██    ██  ██  █ █    ███    ██ █ ██  █  ███ █  █ █████ █ ██    █ ██ █   █   █████ ██████  █     ██   █  █       ███ █ █   ██  █ █ █ ██
██ ██  █   █  ████ ████       █  ███   ██       █   ██  █  █  █  ██   █    █ █ ██ █ ██ █ █ █  █ █      █   ██   ███  █ ██ ██ █ ██████  ██    █    ███ █  █     ██  ██   ██  █████  ███           █ ██ ██   █ ██      █    █  █   █ ███  ██  █  ██ █   █  █████  ██     ████     █ █    █
███    ██ █   ██  █  ██ █    █  ██          ███   █  ██ █ █       █  ███   ██ ██   ██ ██ █     ███     ██ █████████ ███      ████  ███    ███ █ █ █ █  ████       ███████     ████  █ ██ ██   █  ███     █ ████ ██     ███ ██  █  █   █     ███    █  █ █  █     ██   █ █  █ █ █    ████
██  █ ████  ██ █ █  █ █   █   █   █ █    █    ██ █ █████ █   ██  █ ███  █   █ █ █  █ █       ██ █ █  █  ████ █ █ █     █  █  ███ █     ██  ███  ██ ███ █   █  ██ █  █    ███ █ ██ █     ██      █  █ ███ █  ██ █████ ████   █  ██  █      █  ███ ███ ██   █  █ ████ ██  █  █████ █ █   █
███ ██   █      ███  █  █ ███     █    █   ██ █ ███  █    ███ █  █   █ █ █  █ █████ ███     █   █ ███ ███    ██ █  ██ █ █    ██  █     █ ██   █ ██ ██  █ ███ █  ██ ███   ██  ███       ███ ██ ██ █ ██ █ █      ██    █ █  ██  █ █  █ █ ██ █████  █ █  ██  █  █ ███     ███ ██ █ ███ ██ █
██   ███ ██      █ ███ ██   █  █        █      ███  █  █ █  ██ █   ███   █   ███  █ ███  ██████ █    █ █   ███ ██  ██    ██   █ █████  ██ █  █  █   █ ██ █  ███  ████████   █ ██ █  █ ██    █    ███ █  █ █ ██    █ █ █  ██  █  ██ █     █ ██    █  ███ ███ ███ █    ██████    ██  ██  █
██ ██ █ █         ██   █ █      ██   █  ██    █    ██   █ █  ██ █  █ █  █  █  █  ██ ██  █    ██ █   █      █  ██████ ██ ███  ██  ██ █████ █████  ████   ██ █ ██ █   █     █  █       ███ █  ███          ████ █ ███    ██ ████   █████         ██    █   █ █   █  █  ██  █ █ █ █   █ █ █
█ ██ █   █ ███  █████  █   █  █  ██ ████  ██ █ █  ██ █     █ █               ███     █    ██ ██    █    █ █ █ █  █ ██ █ █ █  █ ██    █ █   █  █    ████ ██  ███    ███ █ █ █     █ █  ██  ████  █    ███     █ █ ██   ██  █ ███ █ █ ██   ██    █ ██          █  █  █  █   █████  ██   ██
██   ██      █ █  ███    █ ████  ███  ██  █ ████  █    █ ██ █ █ ██████  ████ █  ██  ███  ███ █  ██  █ ███ █ █   ████    █ ████  █ █  █  █ ██████  █   █ ██████ ██ █   █ █ █     █    █  █      █    █ ███  █        ██  █    ██ ███   ████  █ █ █ ████ █ ██ ███ █  █  ██   ██ █  █   ███
██████  ███  █ █ █        ████  ██  ███   █ ████ ███   █  ██ █ ███ ██        ████   ██  █ █     ████ ███ █████ ███  ██ █ █   ███ ███ █     █ █   █    ██ ██  ██   █ █ ████    ██  █     █ █  █    ██    █   ██ ██ █  █  █   █  █ █  █    ███  █  █  ██ █████ █  ███  █ ██  █ █ ████  █ █
█ █████ █ █ ██ █ ██    █  ██ ██ █  █ █     █     █   █   ███  █  █ ███ ██ █ █     ██ █ ██████ █   █ ██     █ █  ██ █   ██████ █ █   ██  ██ ██  ████  █████   ███     ███  █         ████ █ ███  █ ██ ██ █████  █ ██ █     ██ █ █     █ █   ██ █████ █   █      ██   ██ ███  █ ███  █   █
█    █ █     ██  ██   █ ███ █ █  █    █   █ █ ███ █ █  █  █  ███   ██  █  █ █ █    █         █      ███ ███   █    ███  █  ███  ██ █   █████    █ █   █ █    █ ██   █        █ █████  █  █ █  █      █ ████ ██         █  ██ █ ██      █ █ █   ████ ██  ██  █ █  ████ █   ████  █  █  ██
████████████████████████████████████████████████████████████████████████████████████████████████████████████████████████████████████████████████████████████████████████████████████████████████████████████████████████████████████████████████████████████████████████████████████████
