████████████████████████████████████████████████████████████████████████████████████████████████████████████████████████████████████████████████████████████████████████████████████████████████████████████████████████████████████████████████████████████████████████████████████████
███  █ ████ ██ ██  █   █     █  █  ██ █████ █   ████ ██      ██ █ █ █  █      █ ██ ██  ████ █  ██  █ ██ ████ █ █ █  █   █  █ ██   ███  █ █    █ ███ █   ████████  ████   █  █   █ █ ████        ██    █ █  █ ███  ██ ████ █ ██     █     ████  █ █ ██        ██   ██      ██  ██ █ █ █ █
██   ██      ███  █ ███   █  █ ██████       ██       ██ █  █        ██ ██   ██  ███ █   ██ █   ██ ███        █ ████ █    ███   █████ ████ ████  ███ ██   █ █    ██  █████     ████    █    █  ███████      ██   █  █ █  █████ █   ██  █  █ █ █    █    ███ ████   █  ██ █      ██ ██  ██
█      █    ███ █    ██   █ █ ██   █   █ █ ███      █ ███ ██ ██   █   ███  █ ██ ██  █████ ███      ███   █     ██   ████  █   ██  ██  █ ██ ██ ██ █████ █   █ █  █ ███ █    █  █   █ ████         █ █ ███ ███ █ █   ██ ████ ████  ███  █ █ █ █ █  █ █  ██     █  ████ ██    █  ██  █    █
███   █   █    █ ███ █  █ █ █  █  ████ █ █      ██  ███   █     ██  ███   ██  █ █    █ █      ██  █  ██    █   ██████  █   ███ █      █    ██   █ █ █      █    █ █  █ █ █ ██████  ███   ██ ██  ███  ██   █ ███ █     █  █  █          █ ██ ██  ██ █  █  █    ██  ██  █    █████    █  █
██   █  ███ █ ██    █     █ █   ██  █ ███  ████  ██   █ █ █    █ ██ █  █ █ █  ██ █  ██   ███  ████ █   ██ ██ ██████ ██  ██ █ █      █   █     █   ██  ██      █      █ ████        █     █ █ ██  █  █  █ ████ ██   █  ████ ██ ██  █ ███ ████  █   █ █ ██  ██  █   ██  █ █    █ █ █   ███
█ ██  ████  ███    █ █ █  ██ ██ ███   █  █ ██ ███   █   ██  █   █  █  ██   █  █   █  █ █ ██  █ █   █  █ █  ███   ██ ██   █ ██  █  ████ ███      █    █  ██     ████ █   █    █ █ ██ █ ███  ███ ██   ████  ████        █  █ ████    █          ████ █      ████        ██   ███ █       █
█  ██ ███ ██   █████ █  ████ █ █ ██   █ █ ██   █ █ ██ █ █    ███  ███ █   ███       ██   █ ███ ███████  ██ █     ██  ██ █████ ██ █  ███   ███    ███  ███  █ █ ██  ████  █  ████ █   █       ██ █ █    █ ████     █    █   █ ██  █     █ ██ ███   ██ █ █ █  █████     █    ██ ██  █ ████
█   █ ██  █     ████      ████ ██ █    ███  █   ████     ███  █  ███  ██   ██ ██ ██  █    █  █ ██    ████ █        █ █████ █ ██       ██ █ █ █  ███   █ ███ ██  █  ███  █ ███             █   █  █████     ██  █  ██ █ █    ████  █ ███   ██ █  █   █   ██ █ █ ████   █ ██  █  ██ ████ █
██ ██  █ █  ███  ███  ██ █ █   █ █ █ ████     ██ ██  █  ██     ██ ████ █     █  █ ████ █  █  ██    ██     ██ ██ ████ █ █████ █ ██ █     ██ ██ █ ██  █ █ █  █ █████  █  ██ ████ ██ █    █  █    ██ ███  ██     █ ██ █  █  █ █ ██ ██       ██ ████   █ █ ██ ███████ ██ █       █  █  ██  █
██  ███  ██  █ ██      ██ █       █ ██   ██     █   █ █  █ █    ██ ████    █  ██   ██   █ █     █      ██     ████ █ █  ████      ██ ██  ███ █ ██  █████      ██ █ █ █ █  ██ █     ███  ███   █   ███   █ █    ███  █ ███ █  █ ██ ███ █ ██  ██   █ █    █████ ███ █ ███ ████   █ ██ █  █
█ ██   ███ ████   █    █   █████  ██ ██ ██      █ █  ██  ██  █████ █   ████  █ ███   █  ███ █ ██ ██ █ █  █       █  █           ███  ██ ███  █ █ ████ █       ██ ██ █ ███  ██  ██████ █ ██ ███ ████ ██ █   ██ ████     ██      ███    █████    ██    █        ███    █   █   █  █     ██
██    █ █    ███      █ ██  █ ██   ██  ██   ████   ████ ██ █ ██ ██   ███    █    █  ██  █ █ ██ █ █████  █ ██  █ █ ██   █ ██  █   ████  █  ██   █  █   █████   ██  █ █ █ █   ██         ██████ ██   █   █ ██ ██    █  █ ██  █████  █  ██ ██    ███ █ █    ██████ █   █ ██ ██  █ ████ ██ █
██ ████ ██   █████  ████      ███  █ ██  █ █ █    █ █ █ █ █  ██     █  ██ ███ ██ ██ █     █ █ █  ████████ █ █ █  █ █   ██ █   ████  █     ████ █   ███  █████    ██  █ █      ██ █     █   █ ██    █ ███  █ ██ █ ██ ██  ███  █  █  █  █ ██  █  █  █  █ ███  █ █  ███ ████ █  ██  █  █  █
█ ███  █ ███  █ ██ █     ██ ██ ██ ███ █  ██  ██  █    █████  ██ ██ █ █  █  █   █ ██  ██  ████    █  █  ██  ████ ██ ██  █    █   ███  █ █████ █   ██  ██  █   █       █  █  █ █ █ ██ █      ██  █ █ █ ███ █ ███  █  ███    █  ████ ███ █ █ ██  █      █ ██   ██  █  ██   ██    █ ███  █ █
█ ███  ███ ████  ██ █ █ ██  ██ █ ████ █ █ █  ██   ████  ███ ███ █    ████  ██ ██  █ █ ██     ██ ██ █      █ █  █ █ █ ██ ████     █ █ ██         █ █     █ █ █ ███ █ ███ ██ █ ██    █ ██   ██ █ █    ███  █ █████   █ █████  █  █████ ████ █   █ █  █  █  ████  █  █  ████   █ ████  █  █
█   █   ███ ██  █ ███  █ █  █ ███       █      █ █ ███  ████ █ █ ████ █████   █ ███ █   ████  █      █ ██  █ █      ███ █    █    ██  █   ██  █   ██ █   ███ █ █     ██  █   ██     ██ ████     ██ █ █ ████  █  █       █ █    █ █  █    ████ ██ █████  ██      █  █  ██  █   █    ██ ██
█ ███   ███    ███    █   ███    █ █  █ ██  ██   █  █   ██    ██      █ █   █  █ █ ██   ██ █ █  ███   ███ █   ██   █ ██ ███   ██   ███ ██ █████     ██   █   █ █████ █████ ██████ █ █     ██      █ ███  ██    ██ ███ █ █  █  █ ███  ███████ █   █         █  █      █    ██  ██    █ ██
██ █ ████  █     █    █ ██ ███ █  ██    █ █   ████   ███ █    ███ █   ██ ████   █  █    ██ █  █ █ █    ██ █  ████  ██   ██      █   █   █ █ █ ██ ██ █ ███          █  ██ █    █ █████   █  █   ██ █    ██████ █  █  █  █ ███ ██ ████   █     █  █ █   █ ██ █ █  █    █   █████  ███ █  █
█ █ █    █ █ █   █    █ █ ██   █   ███ █ ███          ██  ███  █ █ █  █   █       ██ ███  ██   ██ █ ████      █    █  █   █   █   ██ ██ █  █     ██     ██    ██ █  ███ █ ██ █   █  █ █  █  ███      █  █   ██ █    ███ █  ██  █     █ ████     █████  ██    ████    ██  ████  ██  ██  █
█  █ █ █████ ██  ███  █    █ ██ █ █ █  ███     █ █  ████ ██          ██ ██  ██   ██ █   ████   █   ██ █   ███ ██  █ █ ████ █  █████     █  █  █      █ █ █ ██ ██████  █  ███ ███ ██ █ ███  ███ ██ ██  █ ███ █      █ ██  █ ███ █ █ ██████ █       ██ █ ██ ███ █  █   ██   ███    ██ █  █
█    ██  █ █       █ ██ █ █ ███  █  ███  █ █   █ ███ █ ██ █ ███  ██   █   █ █   ██ █ █ ███ █ █   █ █  ██ ██ ███      █  ███ █    ██ ███    █    ███ █   █ █ ██ █ █ █ ██   █  █ ██   ██  █     ██████  █      ██    ██ ███ ███  █ ████  ██ ████ █  ███   █     █ █  ██  █ ██  ██  ████ ██
██ █  █ █ ██ ██ █  █       ██  █ ██    █    █ █  █          ██   █ █ █      ███  ██    █ ██   █   █ ██    ███  █  █ ██  █ ███ █ ███ ██ █ █    ████  █    █  █ █ ████ █████   ███    █  ██  ██ █ █  █ █████ █      █  █ ███  █ █    ██  █  ███ ███ ██ ██ ██████  █ ██ █   █   █ █ ██  █ █
██    █ █ ██ ██ █   █████    █ █ █   ███ ██ █ ██████       █ ██ █ █ ██ █    █    ██ █ █ ████ ███  ██  ███ ███ ████ █     ███   █████  ████ ███ █ ██  █  █  █      █ ██      █ █ █ █  █ █ █  █   ██ █ █ ███ ██ █  ██   ██     ██    █     ███ ████          ████ ███ █ █  ████ █ █   █ ██
██ █  █  ██ ██   █   █ ███ ███ ██    █ █  █          █   ██ █   █████ ███ █ ███ █     ███   ██ ███  ███   ██     ███ ██    █████  ███████ ██   █ █ █  ██ █ █       ██  █ █ █  ████ █ █ █  ██  ██   ████   ██ █ █   █ ██████     █  █  █    █  ████  █ █     █ ██ █  ██ █  █ █ ██ ██  █ █
████ ███ █   █ ██   ██ ██   ██     █ █ ██  ████ █ ████   ██     █   █    ███ █   █     █   ██ █  █ █ ███  ██ █ █    █    █ █         █ ██ █ ███ ██ █ █  ███ ██  █ ██████   ██ █ █          ██      ██ █ █ ████ █████ █ ██ ███████ █     █  █ █       ████ █  █ ██ █████    █   █   █████
███  ███      █    █ ███  █ █ █   █ █   █ ████  ██████ █   ████  ████   ████   █  ██     █ ██ ██     ███   █   ██  █ ██ ███ █   ███  █    █  ██         █    ████████    █ ██        █  ████ ██ ████ █ ██ █ █  █   █ █████ █  ██ █   █ █      █ █ █ ██████ █   █   █   ███ █████ ██  █ █
█ █████ ██   ███ ██  ████  █ █ ███    █   █ ██   ██ ██ █  ██ █ █  ███   █ ██ ███    █ ██ █ ██ ██      █  █     █    █ █  █   █ █ ██   ████ ██ █    ███  ██  █ ██  █ ███  █ █  █   █  ██   ██    ███     ██   █  █    █  █ █  █  █ █ █  ██    ██   █████  ██ █   █ ██ █   █ █ █ ███  ██ █
█ ██   █  █ ██   █ █ ██ █   ██     ██ ██  ███ ██ ███  █ ██  █    ███  █████       █  █ █  █  ██ █ █      █     █  ██  ██    ████ █ ██      ██ █  █     █     ███████ ██        █ ██        ██ █     ███  █ █ █        ██  █    █    ██  ██ █ ███ ██ ███   ███    ███ ██   █ █ ██   ██  █
█ █ █   █ █    ███ █   █   ███ █ █ ██   █   █ █ █    █ ██  ██    █ █ █ █   █ ███ █     █  ██ ██ █ ██  █ █ █   ██   █     █ ███ █ █   █ █ █████  ██   ████ ██ █ ███  █  █  █ ██ ██  █ █  ████     █ █ █████ ██ █ █ █       ██   █  █ ████ █ █ ██  █  ████   ███ █    █ ███ █     ██ ███ █
█        ██   ██ ██  ██ ██ ███ █ █ █   █  ███  ██ █     ███  ██ █████          █    █    █      ████  █ █ ███ ██ ███   ██  █ █   █    ███ █ ██     ███ █  █ █ █         █    █ ██ ████ █  ██ ██ █  █████ █ █ █   ██  █ ██ █      █  █   █  ██ ████  █ ████  █ █         ██ █   ██ █ ██ █
████  █     █ █ █    █ █    ███   ██ █ █       ██        ███      █  █   █      ███ ███████  █ █ █  ███████    ██   █ █  ██ ███     █████ ███ ██ ███   ████   █         ██  ██ █████ ██ █ ██    █ █ ██ ████ █ █████  ██   ███  ██  ██  ██ █  ███ █  █  █  █ ██   ██  ███ ███  █    █  ██
█ █ █   █        █████     ██ █  ██ █ █  ███  █ ██ █  ██  █ █   █     █  █ ████  █ █   █  █ ███  █████ █   █ ███ ██      █ █ ███   █ ██████  ████ █   █   ██████ █    ████  █ ██ █  █████ █ ██    ██  ██ █     ██  ██ ████ ██     █  █  █ ██ ██ ███  █  ██  ██ █ ███   █   ██ ██ █ █████
██   ██ █ █     █ ████ ██ █████ █  ███   ██ █ █████    ████  ██  ██     ███ █ █   ██ ███ ██ █ ███    ██ ████ █  █    █   █  ██     ██   ███  █   █ █  ██     ███  █  █ ██     █  ███  ██   █ ███  █  ██  ██  ███  ███ ██      █ █  ██  ██   ██     ███      █      █    █   ██   █ ██  █
███████   ██      ██ █     ████ █ █ ████ ██  ████ █ █ █ █ █   █ █          ██  ██ ██ ██ ██  ██   █ █  █ ██       ███ █████ █  █ █  █     ██  ██ ██ ███    █  █ █ ██   █ ███  █  █    █████   ██  ██ █ █ ███    ██ █ █ ████     █ █   █████  █ ██ █ █ ██  ██ █ █  ██ █ █  █ █  █  ██  ███
█  █  █ ██         ██   █ ██  ██ ███  █    ██ █  █ ███ █       █████ █  █   ██        ██ ██  ██ ██    █    ██ █ █ █ ██   █ █ ████   █ ███ █ █ ██       ██  █   █   ██ █    ████ █   █     █    █ █ █     █ █ ████████   █   ███   █ ███████  ██  ██  ███   ██   █ ██████  █   █  █   █ █
███ ██ █ ██ █ ██ █    █ █      ██ █     █ █  ███   ███              ███      ██ ██      █ ██ ████ █  █ ███ ██  █  █  █ ██   ████   █  █     ██ ██  ██    █    █  ██ ██ █ ███     ██  █    █    █  █ ██   █ ███  ██ ████ ██ ██ █ ██ ███ █ ██ ██   ███   █ ████  ███  █ █ ████   ███   ███
█  █████   ██ █ █████ █ █████    ██  █ █  █  ████      ██████   █  ███████      █   █  ████    ██   ██ ██ ██     █  ███  ████ █ ███ █ ██ ███ ██  █ ███████ █ █ █  ████  ███  ██  ███ ██ █████    ████ ██   █      █ ██    █ █  █ ██ █ █    ██      ██  ████████   ██  ███  █ █████  █  █
████ █  █   ███     █ ██████████   █ █  █ █ ██             ███   █     █ ███ █ █ ███ █ █ ███ █ █   █    ██  █ ███ █   █ █   █ █   ███ ██  █  █  ████ █    ██  ██ █ █       ██ ████  █ █  █   █    █ █  ██   █  █  ██  █     ██  █  █  ██ ██ ██  ███   █   █   █ █   █ █  █  ██  ██ ███ █
████ █    █████ █   █  █      ██ █    ██ █ █ ███  █   █ █  █  █  █ █       ████  █  ██   ██ ██  ██████ █ ███  █   █  █ █ █ █  ██ █ █    ███ ████ ██ █  █ ██      █   █   █ ██ █  █  █ ██ ██ ██ █ █ █ ███ ███   ██  █ █ █    ██  ██    ██  █  ███   █    █  █ █ ████  ██ ██      █   ████
██      █████  █     ██       █       █  █ █   █  █ █             █  ██  ███    █ █   █   █    ██  ██ ██  ███ █  █ ██  █    ██ █   █ █    █ █   █  █  █  ████  █ ████    █  █   ██   ██ █ █    █ ██ █ █  ██     ███ █ █         ██    ███  █████  █  ███  █ ██ █  █████ █  ██ █      ███
█    █   █ █  █ ██    █    ██ █   █ █   ██ █ ██  █         █       ██ █  █  ██  █ ██  █      ██  █  ██ █  ██   █ ██   █ ██ █  ██████ ███ █  █   █ ██    █  █  █████ █ █  █  ██  █   █ ██  ██ █ █   █ █    ██   ████       ███        █ █  ██  █ ██  ██       █  █ ███ █ █  █   ██████ ██
███  ██ █ ███   █  █  ███ █    █  █ ███████  █   █     ███   ██  █    ██  ████ █    █    ███      ███ ██ █   ██     █  █ █  █  ███ █ █ ███ █████    █   █ █ ██    ████ ████        ██ █  ███ █  ██  ███ ██   █ ███  █  █  ██ █ █ ███ ██  ██ █ █      █  ███  █ ███   █  ██ ██   ███   ██
██ █  ██████ █  ███    █████  █ █ ███   █████ █ █ ██ █ █  █ █ █ ██ █   ██    █ ██ ████  ██  ██ █ ██  █████ █      █  █  █   ███████  █ █  ██  ███  █  █ ██ █    █  █ █ ███    █ ███    ██      ███ █   ████  ███ █ ██  █  ██  █        █     █ █    █ █  █  ████ █ ██    ███████  ███  █
███ █ ██ █  █   ███████ ████  ██   ███          █   ████ ███    █   █ ██   █ █    █    █       █ ████   ██       ██    █ ██  █     █ █   █       ██ ██     █ ███ ██ ██   █ ██  ██ █ █ ████ █████████    █ █████ █    ███   ███ ██ █  ██ █ ██  ████   █   █ ███ █  ████    ██  ██ ██  ███
█ █    █ ███   █  ██      █ █ █ ██ █ ███   █ █  █ ██ ██ █ █ █     █ █ ██  █   ██ █   ██ █    █  ███ ███     ██ ██ █ █  ███    █████   █  ███ █  █  ████  █ ███    █ █      █ █  █ ██ █  ██ ███ █ ███ █  █ ███  ████      █          ██ █   ██  █  ███  ███ █ █     ██  █ ███    █   ████
██    ███ ███ █ █  ██    ██ █    ███ ██ ██ █ █   █ █ ██     ██   ██    ██ ██ █   ██      █ █  ████ █ █   █   █ █████   ███     █ ██ █ █   ██  ████   █ █████  █     ██   █ ██ ██ █   █      ██  █████████  █  ███ ██  ███ █  ██ █   ██ ███ ██  █ ███        ██ █    █  ███ ███   █   █ █
█  █ ███ ██  ██  █    █  █  █  ███    █   █ █ █ █ █ ███   █ ████   █ ████   █  █     █  ███  ██ ████  █     ██ █  ████  ██   ███   █           █  █     █        █████  █ █  ██   ████  █ █          █   ██ █    █  █ ████ █  ███  ███     ███ █ █  █ ██ █████ ███  ██   █   █ █ ██  ███
█  ███  █      █ ██  █ ██   █ █   ██  █    █       █  ███ █  █ █  █ ██  ██  ████  █  █  █ ████ █   ███  ██   █ ██  ███ ██ █   █ █  █ █     █  █  █ ██  ██  █  █      █   ██ ██████ ██  █  ██   ███    █  ███ █   █ █  █ ████  █ ██   ██   ██     ██ █   █   █ █  █   █ █ ██  ██    ███ █
█ █  █████ █  ██    █ ████ █ ██     █  ███ █ ████ █   █   ███ ██  █  █  █ ██ █ ██     ████     █ ██  █     █  █  █   █  █        ████ █   ██  █  ██ █    ██ ███████  █ █   ██  █ ██  █  █  ██  █  █ █    ██ █ █████ ██    █ █ ██  ██ █  █   ██    ██     ███  ██ █      ██   ██ █  ██  █
█ ███ █    █ ███ █ ██ █ █ ██ ██  █ █   █ ███  ███ █ ███ ██ █  █  █ █ █     █ █ █   █████████ █ ██          ██  █     █  ██ █████      █    █  ██ █      ██████  █   ██      ███ █ █ ███ ██ █ █ █ █    █ █  █   █       █   █  █ ████ ██ █  █ ██   ███ ██ █ ███    ██ ██    █ █  ██████ █
█ █ ███   █ █   █████ █ █  ██████   ██    █ █ ███ █ █ █  █ ██ █ █ █ █  ██   ██   █ █    ██      █   ██ ██  █   █    █ █     ██ ██ █   █   █  █ █████     █  █   █     █  ██ █ █   ██ █  █ ███  █████     █ ██   ███ ████  █ █ ███ █  █  ██ ██ █  ████ █   ███      █     █  ███ █     ██
█ █  ███  █    ██   ██      █  ██ ██  ███ ██ █   █    █ ██   █  ██ ██ █   ██ ██  ██  █   █ █   █ ██  █       █    █  █ ████   █ █  █     █ ███ ██  █  ██  █ █ ██ █ █      █    █ █ █    ███    ███   ████  █   ███ ██ ██  █ █  █ █   ████ █ ███    ██     ██ █ ██ █ █  █  █  ██ █ ███  █
██  █ ██     █ ██ █   █ █  █ █ ███ █ ██   █   █  █  █ █████   █ █ ██ █ ███  █ █  █  █ ███   ██ █   ███   ███ ██    ██   ██  ██  █     ██  █  █ ██████ █  █ █ ██ █  █    █  █ ██ █ █  █ █   █   ██ █  █     ███  ██     ███   ██  ██   ██ ██  █ █  ██  █ █ ███    █  ██  ██       █   ███
██  █  ██   █   ██ ██   █ ██ █ █   █ █  █ ███  ██████ █ ████  █  ██ █ █  █ ██ █ █ ██ █   █   █   ██  ████      █     █ ████ █ ████  █ █████  ███ ██  █ ███████ █ █  ██████  ██      ████    █ ███ █ █   █████ █ █ █ █ ███  █   █ █  █ █ █ █ ██   █ █  ███   ██ █  █  ███ ████ █ █  █  ██
███ ██ ██   ██ ██ █ ███         ██ ██  █   █  █ ██ █████     ██ ██ ██ █ ██ █ █  █ ██ ███    █ ██  █   ██   █ █ █████ █ █ █ ██ █  █ █   █ █ █      ██   ██   █    █ ██   █ ██  █  ██ ████  █ █  █ ██    ███  █ █ ██   ██  ████ █ █ █  ██              █ ██ █ █   ██  ██ █ █  ███████ █  █
█████    █ █  █ ██  ███  █    ███    ████ █   █    ████ ██ █       ████  █ █ █████   ████   █ █   ██ ██  ██ ██ █ █ ██ █  █  ███  ██  ██ █       █  █   ██  █    ████   ██ █   ██ ██  █ █ ██   ██   █  █    ██ ██  █  █ █████ █        ██   █   ██ ██ █       ██     ██ █ ██████ █ █  ███
███  █  █  █     ██ ███   ██  ███ █ ██  ██ █  ██ ██  ██ █  ██  ███  █ ██   █ ███  ██   █ ██ █ █  █ ██  █████ ██   ███  ████ ███  █    ████████   █ ███  ██ ███ █ █████████  █      █ █ ███ █  ██ ███ ██ ██ ██ █ █ █ █████   █████ ██   ███   █ ██   ██ ██  █  █  ████  ██ █  ███  █    █
██   █ █████  █  █ ████   █  █ ██   ██ █  █      ██ █  ██        █  ██ ███ █    █  █ █ ██ ████ █    █    █ ██ ███      ██ ██ ██ █       █ █ ███  ██ █     █ ██ █ █     █        ██  ██       █ ██ ██   ███ ██    █████ ███ ██  ███    █  █ █   ██  █ █  ██ █ █  █ █   █   █ █   ███  ███
██  █ █   █ █  █ █  ████  ██   █ ███  █   ██  ██ █    ███ █ ██   ███   ██   ██  █  █ █ ██ █  █ ███   █   █ █  ██ ██ ██   █       ███  █ █     █ █  █ █ █     █████ ██ ██  ██ █  ██     █  █ █  ██    ███   █ ███ ███ █ █ ████     ████  ████ █  █ █ ██    █  █ ██   █ ███  █   █ █  █ ██
█ ███  █ █ █  █   ██ ██ █ █ ███ ███ █    ██   ███ ███   ███ █   ██ ███  ██   ██ ██  ██  █  █████ █     ██ ██ ██ █    ██  █ ██ █  ███ █  ██ ██      █ █  █ █  ██ █ █ █ █   ██████  █    █   █████ ███ ██ █ ██   █ ██ ████ █  ████   █ ██  █ █ █ ██  ██ █  █ ████ █   ███ ██  █   ███   ██
████ █  ███  █  ████ ███   █ █ ██     ██ ███ █  ██      ████     █ █ █ █   █ ██               ██ █ █ ██  █ ██ █    █████ ██  ███ █ █     █   ██ █  █       █ ████  ██ ██ █   █████  ██ ███  █ ███        █     ██   █   █     ██  █ ███   ██████    █ █  █  ██ █   █   █     ██ █   █ ██
█ █████       ██  █ █ █      █ ██ ████ ██ ██ █    ███ █ ███  █ █     █    █ ███   ███ ██ █  █      █████        ███ █ ███ ██ ██ ████████  █ ██████     █ █   █ █  █████ ██ █ ██   █ █ ███  █ █  █   █ █ ██ ██ █  █ ███  █ ██████ █ █ █  █   ██         ███   █   █ █ █   ██ █ ███  █   █
██  █  █   █ ███  █   ████ █   █ █ █ █     █  █ ████ ██  ███ ██    █ █   █ ███ █ █ ███  █ ███ ██ █  █ █ █ █  ████ ██ █   █  █           █ █  █ █ ███████      █ █   █ █ █     █ █ █ ██    ███ ████ █  ███ ██ ██   █ █ ████████   █ █   ██  ████ ████      ███ █ ██ ██   ████ ██████   ██
██ ██   █        ████  ██  █  █     █   ██████ █   ██ █   █  █████ █ █ █      █████   █ █████       █ █  ██        █ ██   ██    ███   █   █    ██ █ █ █ ██   █ █ █ █ ████████ ██ ███  █  █    ████ █   █  █  █  █   █ ███  █ █ ██ █      ██     █ █  █████    ██   ██  ██ █████ ██  █ ██
█████████  █  █ ██     ██   ███    █ █ █  █ ████ ███  ██ ██ ██   █   █ █████ █  █   █ █ █ █   ███   ██       █████   ████     ██ ████   ██ █  █   █  ██  █ ████ █   █ █    ████████ █     ██ █████ █ ████ ████    █   ███    ███ ███     █ ██ ███     █ █   █ █   ██  █████  ████ █  █ █
██        █ █   ████ ██   █ ██ ██ ████  █    █  █ █    ███ ███ █ █ █ ██  █ ████ █     ██   █  ███████    █ █ ███ █ ████ ██        ███   ██ ██  █ ███ ███  █  ██  █ █ ██ █ ██  █ █ ██  ██      █    █    ███ █   █ █ ███ █ ██████     ████    ███    █    █   █ ████ █ ██  ██  █    █   █
████████████████████████████████████████████████████████████████████████████████████████████████████████████████████████████████████████████████████████████████████████████████████████████████████████████████████████████████████████████████████████████████████████████████████████
