████████████████████████████████████████████████████████████
████████████████████████   █████████████████████████████████
████████████  ███████        ██████   ████████████  ████████
███  ██        ████            ███    ███████████     ██████
██                                    ███               ████
██                                   ███                 ███
██                                   ███                  ██
██                                   ██            ██     ██
██                                                ████    ██
██           ███      ██                          ████    ██
██          █████    ████                         ████    ██
██           ████    ████                  ██      ███    ██
██            ███    ███         █       █████            ██
██             ██     █         █████████████             ██
██                               ████████████             ██
██                                ██████████              ██
███                                  █████       ██████  ███
█████                                 ██        ████████████
████████                                       ████████  ███
█████████                   ██                ████████    ██
█████████                  ███               █████████    ██
████████                    █                ███  ███     ██
████████                                     ██           ██
█████████                                   ███           ██
█████████████                            █████            ██
████    ██████                     ██   █████             ██
███       ██████████████                █████             ██
██         █████████████                 ███             ███
██          ██████████                                 █████
██           ████████                        ██       ██████
███           ██████                       ████       ██████
███████        █████          ███ ██      █████      ███████
████████         ██      █   █████        ████       ███████
██████████              ███  ████          ███       ███████
███████████             ██   ████           ██       ███████
███████████            ███    ██            ██       ███████
██████████             ████   ██      ███  ███      ████  ██
██████                 ████   ██     █████████     ████   ██
███            ██       ██           █████████    █████   ██
██            ████                   ████████     █████   ██
█             ████                    ██████      █████  ███
█              ██                      █████      ████   ███
██                                      ████      ███    ███
███                            ███       ███    █████    ███
███                 ██         ███             ██████    ███
███                ████                        ██████    ███
████              ███████                      █████     ███
█████     ███     ████████                      ███     ████
██████   █████        █████                     ███    █████
███ ██████████         ████                     ████   █████
██   ██████████        ███                       ███    ████
██     █████████      ███                        ███    ████
███      ████████      █                         ██      ███
███        ███████                              ███      ███
███        ████████                              █       ███
███        █████████   ██                                ███
████      █████████████████                             ████
█████    ████████████████████████              ██      █████
████████████████████████████████████████████████████████████
████████████████████████████████████████████████████████████
