████████████████████████████████████████████████████████████████████████████████████████████████████████████████████████████████████████████████████████████████████████████████████████████████████████████████████████████████████████████████████████████████████████████████████████
█ █    ████ ██ ██    ████ ███   ██    █ █   █   ██ █ █ █  ██ █████  █ ███ ██ █ █     █ █  █   ███  ██ ██ █    █ █ █       ██ █ █ █  ██  ██ █  ███   ██ █    ███   █     █ █   ███ █ ██ █ ██████ █  ██  ██  ██  █████ █    █  ██    ██  █   ██ █  ███ █  █ ██  █ ███ ███    ████  █     █
█  █  █ █ █ █ ███ ██  █  █    █ ████ ██ █ █ █  █ █    ████   ███  █ ████ █      █ █ ███  ██  ███████ ██ ██ █   █   █     █ █    █  ███ ██  ██     █ █    █       █  ██ █  █ ██   █  ██ ██  ███   █  ██ ████  █ █ █  ██   █   █  ████ █  █   ██ █       █████    █ █   ██    ████    █  █
███ █ █       █  █ █ ██  ██ █ ██  ███ █  █ █    ███     █   ██  ██  ███  ██ █ █    ███  ████   █████  ███  █ ██ ████    █ ██ █  ██ ████ █   █ ██ █████   █  █         ██ ████    █  ██ ██  █     █       █ ██      ███  █████      █  ███   █ ███ █  █  █ █     █████ █ ████ ██ █ █  ███
███     ██   █ █   ███ █  █    ███  █  █ ███ █ ██ ██  █   ██    ██ █     █   ████  █ ███     █   ███     ███ ██ ██ ██    █ █ ███     █ █ ███ █ ██ █ ██  █    ██  ███    █ █ █ █ █ █    █  ██ ██  ███    ██ █        ██  ██ █ █   ████  █ █    █ ███  ███    █ █   ███ █  █ ███ ██  █  ██
█  ████ █ █  █ █ █  ███    ███  ██████      ████ █         ██ ████ ██  █   █ ██  █  ██  ██   █  █  █    ████ ██   █  █ █ ██   █    █   █ ██ █  █   ██ ██    ████  █████  █   █  █ █  █ █  █ █ █   ███████ ██ █  ██ ██     ██ ███ █ ██ ██  █     ██ █ █ ████ ███  █  █  ██  █ ██ ███  ███
█ ████ ███  ███  █  ████ █ ██ ██ ████ ███       ██ █████ ████ ██  █  ██    █ █ ██ █        ██ ██  █ █ █   █  ███ ███   █ ████  █  ██ █ ███   █ █ ██  ██ ██████   █ █ █   ██ █  ██  █ █   █      ██ █  █ █  ██     ██  ███   ███ ██  ███ █   ███████████ ██  ████     ██         █ ██  ██
████ █ █ ██  ██  █    ██   ███  █ █    █████     █ █  █  █ ███ ██    ██       █  ████████ █ ██ █ █  ███           █  ██   ██  ███ █ █     ██  █ █  █  █ █ ██ ██ ████   █  ██ ██      █      █ █ ███ ██ █ ████  ██ ██ ██  █ ████ █  █ ████ ███  █ ██   █ ██  ███ █  ███    █ ███      █ █
██ ███   █  ██ █ ██  █       █   █  █  ██ ███   █  ███ █ █ █   ████ ███ ██  ███ █ ███ █ █ ██   █  █ █    █ █ ███  ██ █ ██       █   ███  █  █ █  █ █  █ █ █  ██ ██ █ █   █████ █ █ █       █  ██  ██  ████ █  █ █ ██ ███   █  █ █  █   ██ ████   █      █     █ ███ █ █ █ █ ██ █ █  █  █
██    █████   █ █ █ ██      █   ████ █      ████ ██ █   ████ █  █  █    ███    ██ ██ █ █     █ █   █ ███ ██  █    ██   █  ███ █     █  ██ ██   ██ ██ █ ████  ████ ██ ███ █ ██ █ ██ █  ███ █ ███ █ ██ ██ ███  █  █ █ ███ █ ██  █   ██  ██ ██ █ ████    ██ █   ████ █ ████  █       ███  █
███    █ █ █ ██ █ █ █     ███ █ █ █ ██ ███       █  ██    ████ █ █  ███  ████ ██ █ █ █████  ██ █  ███  █     █  █  █    █ ██ █ ██ █  █    ██  █  █ █ █  ███  █ █████ █  ██   ██     ████ █ █  █ ██ ██     █ █     ██         █ █ █ ██ █  █ █  █ █   ██ ███ ███ ████  █  █ █ ██ ███     █
████    ██ ██ ██  ██ █  █  █  ███ █      █  █  ██ █ █   █    █ ████   █    █ ███  ████   █     █   █ ████  █ █ ██ ██  ███  ██   █  █    ██   █  ███   █ ███ █    ███    █ ██  █  █      ██  █  █  █   █       █ ████ ████ ███ █  █       ████ █    ████  █  █     ███   █ ██ █   █ █ █ █
█ ██   █   ██ ████  ███ █ █ █  █ █   █ █   ███ █    ██   █  ██    █ █  █ ██     ██       █  █ ██ █   █    █ █   █ █     █ ███   ██ ██ █ █   █ █ █████  █ ████ █ ████ █ █  █   ██  █ █ █ ██ ██      █  ███  ██         ███   ████ ██████ █ █   █  █  █ █  █  ███████   █    █   ██  █  ██
███  ██  ███   █ █ ███ ██  █ █ █ █ ██  █    █ █            █     ████  █  ██ ██ █ ██ █     █ █ █  ███ ██  ██    ██     █  █   ██   █  █ █ ██ █ █ █  █  █  █  █    █     ██ █  █ █  █ ██     █      █    █    ██    ██ █    █    █  ████ ███ █  ██ ██████   █ █    ████████   ██ ██  ████
█   █ █  █████  ███ ██ █  ████ ███ █  ██ █ ███ ██ █  █   ██ █   ██  █  ████ █        ███ ████   █ █ ████   █  █  █ █ █  ██   █       ███  ██  ██ ████ ██  ██ █ █ █ ████    █ █ ██   █ █  █ ████   ███ █   █  █  █    ██    ███ ██  █  █     ██ █   █ ██ ██ ██████   █  █ ███ █ ███ █  ██
█ ███     █  ██ ███    █ ██    ██████ █    ████  █    █ █     ██ ███ █  █  ███ █████    ███ █ █ ██  ██    ██     ██ █ █ █  █ ██  █       ██      █   █ █  ██ ██  ███  ██ █  █ ██ █ ██ █ ████  █ ███   █   ████ █ ██  █ █  █  █ ██ █ █ ██     █  █  █  █ █  ██ █  █ █ █  █     █████  ███
█ ██     █       █      █  █ ██     █ █ █  ███   ██ ██  █ █  █ █  ██ █████ █ █  █  █ █     ██ █   █ ███     ██ ██ █       ██   ██ ██  ██    █  ███  ████     ███   ██ █ █  █  ██  ████     █  █ █ █  █        █    ████  ███ ██  ███   ██ ██  ██  █   ███████   █ █ █   █  █████   ██  █
█  █  ████ █  █   ██  ███ █████     █ █ ████ ███ ██     █ ████     █  █    █   █   █ █  █    █  █     ██ ██████ ███       █   ██   █     █     ██   ██ ███  ███   █ ███████ ██   █       ██ █   █      █ █   █          █ ███ ███ █ ██  █  ██ █ █ ██ █ █ █ ██ █████  █ ███ █    █  ███ █
█       █ ██  ██   ██ █ █ █   ███    ██    █   █ █  █ ███ ██  █  ██    █ ██ █ ██ ██    ███ █    ██  █  ██   █  █       ██ █ ██ ██      █    █ █ ███    ███    ██   █  ███   █ ███ ██ █ █  ████ █          ██ █ █     ████  ████ █ ██  █   █   ███ ███ █   █ ███   █ █    █ █  ██  █ ████
█       ██ █ ████  ██████  █ █ ██ ████  █ ██ █  ██  ██ █ █████  █████ █ █  █  █ █     █    ██ ██ █ █ █  ██     █  █  █    ████  █  ███ ████    █  ██ █   █   █  ███ █   ███   ███      ███  █ ███  █ █    █  ███ ██ ███  █   ███ ██ █ ███ █  █ █  █ ██ ██  █     ██  █ █      ██  ███ ██
█ ██ ██ ███  █████ █ ██ █ ██ █ █ ██ █  █  ███    █  ████ █ █ █ ███ ██     █  █ █ █ █    █   █    █ ██  ██   █ ████ █ █   ███ ███  █████  █ █ █  █  █ ██  ███  █  █ █   ██████ ██ █  █ ████ ██  █          █   ███   █   █         ██      ██    █ ███ ███    ████ █   ████ █  █ ██   █ █
███ ██ █ █ █  █ ██     ████    █ █  █ █  █ ██ ██      █   █  █    ██ █ ███ █  █ █   █████ █  █ █  █  ██       █ ███ █   ██ ██  ████ █ ██ █ ██ █████    █ █ █  █ █ ██  █  █ █  █ ██ █  ██ █████ ██████      █ █ █ ██ █  █   ███ █ █  ██ ██ █  █████  █    █ ██  ███ ██  ██ █ █ ███ ██   █
█ ████ █   █  ███  █  ██████  █   █    ████     █  ████    █ ███  █ ██████  █  █   ███  █ ██ █ ██   ██     ██ █  ███  ████    █ ███ ██████ ██ ███  ██  ██  ████    ██ █  ██████ ██ ███ ██ ██ ██     █   ████  █ █    █     █     ███  █   █  █      █ █ ██ █████ █  █  █ █  █ █████  ███
█    ███ █ █     █            █ ███      ██ ██ ███ █   █ █  ███ ██ █ ███   █ █   █ ███   █    █ █  █████ ███ ████    ██    █ █  █ ███ █ ███ █    ██  █  ███ █ ████ ██████████████ █████ ██    █ █ ███ █ █   ████     ██ ███   █ ███ ██ █ █  █  ██  █   █ ██  ██ ██    █ █ █    ████  ███
█  ████ █    █ █   █ ███  ██ █  █ ██     █  █  █      █   █ ███ ███ █   █████ █ ██ ██ ██       █  █ █  ████ ██   █  █  ██ █ █     █  █    ██  ██ █ █    ███    █   █ █ ██ ██ █ █ █  ██  █  █      ███ █ ███   ██ ██ █ ████ ██   ██   ██ █   ██   ████ █ ██  ██   ███  █    ███████    ██
█  █ █ █ ███████ ███  █  █ █  █████  █ █      █   █    ███  ██   ██████        ██ █  █ █   ████   █ █  █ ██  █   ████  █ █     █████   █ █  █ ██ █  █    ███ █████   █ █    █ █   ███  █  █ █ ███  █ █ ██ █ ████     ██ █  █  █   █    ██ █ █  ██   █ ██    ██ ██████ █ ██     █     ███
█ █   ████   ██ ███   ██ ███  ███ ███   █   █   ███ █ █   ██ ███  █████   █ ████  █    █    █  ██ ██   █ ██  ████    ███ ████ █  █   ██ █    ██  █ █  ███ █ ██       ██ █ ██  █  █ █   █  █████ █  ██   █  ██ ██ █ ██████ █   ██     █ █ ██  █   █  ██ █ █    █ ████  ██ ███ █  █  █   █
█       █  █  ██  █ ████ ████ ██  ██  ███ ██ █████     █ █    █ ███ ███ █    ██  █  █████    █  █  █ ██ █  ██      ████ █  ██  ███ ███████  █     ██████ ██  ████ █ ██     ██   ██    █ ████   █  █  █      █  █ ██ ███  ██ ██  █    █   ███ ██  █ ██   █  ██    █  ███ █  ██          █
█   █ ███  █ █  ███ ███    █  █ █   ██ █  █ ██ █ ███ ██       █       █      ██  █  █ █ █ █        █ █  ███████ █ █████ ███    █ ███   ██████ █████    █ ████ ██   ██ ██  █  █          █  █  █  █     █  █ █ █   █  █     ███ █  █  █   █  █      ██ ██  █ █ ███ █ █   █  █ ████   ██ █
██ █    █    █    ████ █    ██  ██ █ ██  █ █ ███  █    ██     ██ ██      ██ ███ █     ██  █   ███   ██   █ █ ███  █ █ █ ██ █ ██  █   █  ███ █  ██ █   █   ████  █    █ █ ██ █ ███ █ █   ██   █  ████   ███████  █ █████ ███  █ █ ██  █   ██ █               ██  █    █    █ ███ ██  █ ██
██ ████ █ █ ████ █        ████████  ████ ██ ██     █ ███ ██ █ ██   █    ██         ███  ██ █  █ ████    █ █     █ █ █   ██████   ██████  ███ █ █ ███ █ █  █  █   █    █   █   █ █ █ █ █ █       ██ ███ █   █  ██    ████ █  ██  ██  ████  █ █  ██ ████ █ █  █ █  █ ███  █  ███   ██  █ █
█ ██   █  █ █████████    █   █ █  █ █   █ █    █  █   █████  ████ ████ █ ███ █   ██   ██    ████   █  ██  █  █  ████  █  █ ████ █ █      ██  █    ███   █ █     ██  █  █ ██  ██   ██  ███        ██  █ ████ █████ ███████  █████  █  ██████  █ █  █████ █  █ ████       █      ████ █ ██
█ █  █  ██   █ █  ███ █    █ █   █ ███  █ ██    █  ███ █ ██ ████  █  █     █   ██  █████  █ █████ ██  ███████   ███   ██       ██ █ █ ██   █    ██     ███  █ ██ █ █ ██ █       ██ ██     █  ██ ███ █ ████ █ ██ █ █ ██  █ ███   █  ████ █ █ ██   █ █    █ ███   █ █ █  █    █ █    ██ ██
█   █   █ █████   ██    ███  █  █  ██ █ ██ ██ █ ██ █ █ ██  █ █ ██ █ █    █  ██  ████ ████     ██ ██ █ █ ██     █     █ █ ████       █ █  █  ██      █  █ █  █ █  ██ ███    █     ███ ████ █ ██ ██  ██     █ ██ ██ █  ██ ██   █    █ █ █ █████  █   ██  ███ ██ █   █ █  ██ ███  ███ ██  █
█  █  █     ████  ███  █ ██   █  ████ █ ██████        █ █  ███   ██ █ ██  █████ █ █ ████  ███ ██ ██  █        █ ███ █   ██ █     ███ ██    ████ █ █ ██ █  ██ █ █     █ █  █ ██   ███ ███  ███ ██   ████ █       ██  ██ █    █  █   ███   █    █  ██   █    █ █   ███  ███    █ █       █
██      ██ ██ ██    ██     █ ██    ██ █ ██      ██  █  █ ██   ██ ███    ██   ███     ███  █   ██  █ █ █  █   █ █    █  ██   █ ██    █ █    ██████            █  █ ██   █  ████ █ █ █ █ █   █ █   ██    █  ██   ██    ██ ███ ███ ████ ███████ █      █   ███      █     █  ███ █   █ ████
█   █ ██ █  ███████ ██████ █ █ █ ██ ██ █   █ ██████  █    ██ ██   ██  ██ █   █ ███   █ ██ █   █ █████  ████  █     █   █  █   ██     █ ████ ███     ██ ██ ██ ████ █    █     █  █   █ █        █ █ ██ ██ ███   █  ██  █   █████   █  █         █ █     █  ███ █  ███ █ █  █     █   █  █
█   ██ █ █ ████ ██████  █ █  █ ████   █ ████   ████ █ ██  █ ██ █  █ ███ █  █  █    █ ████  █ ██    ███  █   █ █   █ ██   ██ █      ██ ██  █     █   █ █   █ ██ █  █ ████ █████   █  █  ██ █ ███  █  █     ███ ██ ██  █ ███  █ █ █ ██ █  █  █  █    █  █    ██  █     █ █ ███   █   █ ███
██ █    █   █ ██ ██       ███   ██  █  ███ █ █ █  █ █ █ ████   ██ ████ █    ██  █ █ ██ █  ███  █      █  █   █    ███ █ █    █     ██  █     █  ███ █    ███ █  ███    ███ ██      █  █ █  █ ███  █   ██ ██  █     █  ██ █  ████  ████ █ ████ █ ██ █ █ █   █ █ ███  ██   █  █  ██  █ █ █
██  ██ ████  █  ████   █ ███ ██  █   █ █ ███████  █  ██  █  ██   ███     ██ █    ███ █ █  █ ██  █  ██ █  ██████  █  █ ██ █ █   ███ ███   █ ██   █ ████  ██   █  █ ████  █ █    █ ███ ██   ███ █     ████     █ █ ███ █  █ █ ██    ██ █ ███ ██  █ █ █    ████  █ █  █  █  █    █ █    █ █
████ █ ██  ███ ██ █████ ███ █ ████  ██ ████ ██   ██ █      █   ████ ███     ██ █  █     ██ ██ █ █ █ █    █  █ █     ██    █   ██████  ███ ███ █    █   █  ██████ █ █ █ █ █  ██ ██  ████   ████ ███  █  █  █ ██   ███  ██ █    █ █  █    █ ███  █ ██ █   ██  █  █   ██████  █     ██    █
█ ████  ████ █ ████ █ ██ █ ██ ██ █████ ███  █    ████ █████ █ ██ █  ██ ██ █    ███   █████ ██ ██   █  █ █ █ ██ ████      █████       ██   █ █ ███   █ █        ██ █ ██  █  ██ █  █    ███  █ ██   █  ██ ██ █  █   ██    █ ██ █    ███  █ █  ██  █        █   █      █   ██   █ █████  ██
█ ██  █   █   █  ██    ███  █   █ █ ██  █   ██   █ ███ ██ █ █       █   ████ █      █ ███  █  █  ██  █ █████  █  █    █          ██    ███ █     █ ███ █ ██   ████  ██ █    █    ███ █ █ ██  █   █ ██ █       █ █         ██ ████  █  ██    ██ ██  ██ █ ██   █ ██  ██  █  ██████ █████ █
███ ██ █  ██    ██ █   ██  ██    ██  ███       █   ██ █  ██    ███   █ █ █ █    ████   ██   ██  █ ███    █ ██ ██ ██  █ █ █ █ █    ████  █████  ██████████ ██ █ █  ███ █  █████ ██  █  █       ██  ██   ███ █ ██ █ █    █ █ █ ███  █ █  █    █  ███ ██████ ██   █  █  ██ █  █ █ ██   ██ █
█ █   █  █ █  █ ███ ███   ██      █ ████   ███  ███ █ █  █ █ ██  █ ██  █ ██  ██   █ █  █  ██  ████   ██    ███ ██ █ █ █   █ ██    █ ███ █   ██  █ ████ █████ █ █    ██    ██ ██    █  █      ████  ██  █       ███  ██ ██     ██ ██ ██ █  ████ ███        █ █ █  ██ █ ██ ███ ████  ██  █
█     ███  ██   █  █  █ ██ ████ ███         ████  ███  █ █ █  ████  █   █   ██  █    █    █ ███  █  █████ ███ █   ██ █ ██   ███ █     █   ██      ██    ██     ██   █  █    ██ ██ █  ███ ██    █ ██     ███ ██ █   █  ████   █  ██   █  ██ █ ██  ██ █ ████ █      █       █ ██ ██ █    █
██ ██ ██ █   █████ █ ██████ ██ █  █ █   ████    █  █  ██  ██      ██        █    █  █ ██ ██ ███  █     █ ███     █ █    █ █ █  █  ██  █     ██  █   ██    ███  ██   █ █     ██   █ ████   ██  █ █  ██ █   █  ██ ██ ███  ██ █ █   █     █ ███   ███ █   █  █    ██ █        ██ ██ ██   ██
██ ████ ███   ██ ██ █ ██  █ █    █   ██  ██ █ █ ███   █      ██     ██  █████   ██ ████  █ █  █  ██ ███ ██ █ ██ █  █  ███ ███   █    █ ██   ████ █    █  █ █ █ █ █      █    █ ██       ██      ██ ███ ███  █    █  █  █ ████ █ ████ ██    █   ██ ███    █    ███   █  ██     █   ███  █
███    ████   █ ██ ██   █   ██ █ █  █  ████ █    █           █ █  █ █     █ ███████ █ █ █ ███ ████ █ ██         █      ███    ██ █████      ███   █       █ ██ █ █ █  ███   ███    ██   █   █ ███ █  ██ █ █ █ ███     ██ ████ ██            █   █  ██  ██        ██   █   █   ██     ███
█ █  ████ ███    ██  █   ███    ██ █     █  █ █ ████  █   █ █  █  █    ██ ██  █████ █   ██ ███  █ ███  █  █   ██  ███   █  ██ ██ █ █ ██  ███████  █          ██     ██ █  ████  ███ █  █ ███ ██  █  ██████    ██  ███  █   ██  ██ █ █     ███  █ █    █ ███   █  █   ██    █ █ ███   █ █
█   █ ██ █  █ ████  █  █ ██ ███ ██   ██ ██   █   ████  █  █ ████ ██  █ ██  ███ █ █ ████  █    █  ██ █ ██ █  █    ███ ████ █    █  ██    █ ██ █ ███        █ █ █  █ ███ █  █     ██ █ █   ██ █ █       █     ██  █ ███  ██ █    █  █ ██ █ █  ██ ██    █ █ ██ ██ ███  ██ ███  ███    █ █ █
██ █  █     █  ██  █ ████   █  ██  ██    ██ █ █████    █ ██ ████ █  █ █     █ ██ ████ █  █    █ ██ █   █   ██         █ ██   ████     █ █  █   ███ █     █      █ █  █  █ ███ ██ █ █  █    ██  ██ █         █  █ █ █ ██ █       █   █   █         ██ █ █       █  ██   █ ███        ██ █
██ █ █  ██   █  █    █ █ █   █ ██   █ ████      ██   █  █           █ █  █   █  █  █ █    █  ███████ █ ████    ██ ██   ██     ██████ █ █ █   █  █ █ █████████ █    ██████      █  ██  ██   █ █    █ ███ ██  ██  █   █  █ █ █    ██ ███  ███       █   █      ██ ██  ███  █ ██ █ ██  ██ █
████ █ █ █  ██ █  ███████   ██   ████   █ ███ █   █ ███ █ █   █  █    █    ███   ██   ██ █  ██████ █ █  █    █   ██ █ █ █  ██ █      █  █  ████ ███ █   ██  █  █    █████ █ ██   █ █ █   █  █  █ █  ████   ██ ██ █   ███  ██  █    █  █   █    ███        █   █  █ ██  ██  ██ ██   █ █ █
███ █  █ █ ██ ██ ██  ████ █  ██ ███ ██         █  █ █   ███             █    █████  █ ██  █ █  █        █ ████ █    ███  █ ███████ █  █ ██ █   ██   ██ █  █    ██ ███ █ █     █ ███████ █ ███  ██   ██  █  ██ █  █        █ █  █  ██ █    ██ █ █ ██  █  ██ █   ██   █   █ █ ███ █ █ ████
█ █████   █   █        █ ██ ██ █   █     █ ██         ███  ██ █ ████   ██  ██ ███  █     ██ █  ███ █  █    ██ ██ █ █ ███ █ █  █  █       █ ██    ██  ████ █ ███ ███  █ ██ █  ███ █ █     █  ███    █  ██ ██ █ ███  ████ █     █ █  ██ █████ ███   ██   █ █ ██  ██ ██████   █  █     █ ██
█ ██ █ ███ █   █  █  ██  █  ██ ████  ██ ██  █  █     █ █  █ █    █ ██  █  █   ██ ██ █████ █ █ █    █ ████  █  ███  █  ██   █  ███ ██  ██    ██ █████ ██████  █ ███    █  █   █ ███ █ █ ███   █   █  █  █  █ █  █     █ ██   ██  ██  █   ██ ██     ██ █  █ █  █  ███  █    ████   █ ██ ██
██ ██  █ ███     █    █ █ █    █       ███     ██  █   ██  █    ██  ███  ███████  ██ █   █       ███ █     █   █  █    █ ████████  ███  █████ ██████  ██   █ ███    ████ █ █ █  █ ██     ███████ █  █  ██ █████ █     ████  █   █   █  █   █ █  █   █   ██   ██ ███ ██    ██ █  █  ███ █
██     ██    ██  █  ██   ██  ███    ███   █   ██ █     ███ ███  ███      █ █ ██ ███ █████   █  ███      █   ███ █ █ ███ █ ██ █  ██ █ █  █   █   █  ████ █    ██ █  █     █   █ █ █  ██  █ █  ████   █ █  █ █ █       █    ██   ██  █ █  █ █████   ██ █  █      █  ██ ███  ████       ███
█   ██   █████ █ █         █     █ █ ██ ███████  █   █  █ █ █ █ █ █ █   ███  █ █ █ █ █    ██  ███ █ ███ ████  █  ██  ██ ██  █   █ ██ ███  ██ ██   ██ █     ██ ██ ██     █   █        ███ █    █   ███ █ █   █ █   ███████    ██  ██    ████ █ ██ █ ██ █  ██ █ ███ ██ ██   █ █ █   ████ █
███    █   ██    █    █   █ █████  █  █ ██  █ █ ██  █  █ █ ██  ██    ██████           ██  ██  █ █ ████   █████ █ ██████   █ ██   ██ ██ █        █ █  ██ █       █ █   █ ███ █  █   ████ █  █  █  ███ █  ███    █ █████ ██ ██     █  █  █ █    ███     █ █ █   ██  ██ █ ███          █ ██
█  ███ █  █  █  ██ █████ ██  ██    █ █  █ ██████ █  ███     █      █ █ █  ██ █ █ █ ██ ███  ███ █    █  ███ █ █          █    ██ ██   █     ██  █     █    █ █   █  ██    ███ ███ █ █  █        ██ █  █ ████ ███ ██ ██ █     █  ███ █      █   █   █  ██ █  █   █  ██  █  █     ██ █   ██
█ █ ██████   ██ █ █ █  █  ███   ██  █      █  █    █ █   ███ ████ ██ ██████ █ █  ████ ██  █   ███    █ █  █   ███ █ █  █ ████ █  █    ██  █ ███ ██ ██ █      █ █  ██    █   ██  █      █ ███ █ █   ███  █  █ ████ █   █  █ ████  █ █████  ██    █ ██ █ █    ██  █   ███   █  ████ ██ ███
█  █       █ ██     █ █     ████     █ ███  ██    ██     ██   ██████ ████ █ ██ █ ██   ███  ██ ██  █  █ █  ███ █ █  ██    █   █ ██ █   █ █  █  █████     █ ██   █    ██   █ █ █ █     ███  ██ █    █████   █    █ ██ ███   ███  ███     █  █   ████ █ ███  █  ███ █  ██   ██     █ ███  █
█  █  ██   ██  ████████    █ ███ ███ █   █   ██ █ █ █   ██ █  ███ ███ ████  █   █ ███ ██   █ ██  █  █ █ █    █  █ █ ███   ██ ███ ████    ███  █  █     █    ██       █ █   ██   ██ ██ ██ █ █ █ ████ ███   █      █   ███████ █ ███ █   ██   █ █ ███   █      ███      █ ███ ██ █ ██  █ █
█    ██      █   █   █  █  █ ████ █    █████ ███████       ██   ██    █ █    █ █ █  ███ █ ██   █████ █ █   ███  █  █ █ █ █ ██  ███ █  █  █  ██         █ █  █  █   ██ █ ██  █    █   ███  █ ██ █ █ █ ██   █  █    ██████ █     ██ █  ██ █ █ ███ ██    █  ██    █      ██    ██ ██ ██ ███
█    █   █  █ █   ██    ██    ████   █  ███  █ ███  █ ██   ██ █  ██ █ █  ██ █   █ █ ██  █  █ █   █  █ █     ███   █    ███  ██ █    █████  ██ ██ █  ███ █      ███    ██  █  █           █  █   █    ██ █   ███ █   █  ██ ███ ██   █████ ██ █  █ █  ████   ███ █ ██     █  ██████     ██
████████████████████████████████████████████████████████████████████████████████████████████████████████████████████████████████████████████████████████████████████████████████████████████████████████████████████████████████████████████████████████████████████████████████████████
