████████████████████████████████████████████████████████████████████████████████████████████████████████████████████████████████████████████████████████████████████████████████████████████████████████████████████████████████████████████████████████████████████████████████████████
█  ██ █    █ █ █ █   █  ██  █    ███████  ██ █      █ █ █  ██  █ ███ ██ █  █████  ████ █ █ ██           █    ██   ██  █     █   ██     █      █ █   █   ██  █ ████ ███ █ █ █   ██ ███   █   █ ████ █ █  █ █   █ █ █ █ █ █ ██  █        ███ █    ██  █ █████  ██████ █ █   █ █ ██  █  █ █
█ █ █████ █ █  █ █ █    █   ██████ ███  ███   █   █    █ █  █ █  █   ██  █ █ █     █  ██ ████ ██  ██   █ ██ █   ██      ██ █   █ ██     █  ████ ███   █ █ █ █ █ ███     ███ █   ██    ███ █████            ████     █  ███  ██  █ ██ █ ██ █      ██   █ █ ███ █  █   ██  ██ █  ███   ███
█ ██  █     █ █  █ █ █ ███      ██ ██ ██ ██ █  █  ██ █  █ █ ██ ███ █ ██   █  ██ █  █ ███    █ █ █ █ █  █  ██   ██ █    ██    █ ██    █ █   ██ ███  █ █   ████ █ ██ █  ████   ████ █ ███   ████    █     █  ████ ██     ███ ███   ██  ██    █  █  █ ██ █   █   █  ██ ███ █   █   █     ██
██████ ██  █  █ ██  █  █  ███   ███    █  ██ █   █ █ █ █   █ █████ █  █ ███  █ █  ██    ██ █ ██    █ ███    ██ █      █ ██ █  ████  █ ██ ██ █ ███   █ ███  █ ███ ██ █  █ ██ ██  ██ █  █  █ █ █ █ ████████  ███ █   █ █ █   ███  █  ██ ███ ██    ██ ███  █ █  █   █ █ █      █       █ ██
█   █ ██ █  █ █  █ ██    ██   █ █  █ █ █ █  ███   ██  ██ █ █   █ ██  █  ████ ██ ██ ██        ██ █  ███ █  ███ █ ██ █ █   ██ █████  ██  █     ██ ██   ██ ██  █ █ ██  █    ████  █ ██ █ ██  █   ██ ███ █  █     █   █   █      █ █  █ ██    ██ ██ ██  █  █  ██    █ ███ █        ██████  █
█ █  █  █████   ██ ████  ██   ██ █    ██████ ███     ██ ██ ██  █   ██ █  █       █    ██ █ ██ ████ █   ██  ██     █  █  █     ██ ██   █ █ █ ██     ███    ██ ██    █  ██     █  █  █    ██ █    █   █      █ █ █  ███ █ ██ █     █   █ █  ██ ██       █   █  █ ██   █  ████ ██       █ █
█  █    █ ███    ██ █  █ █ █  █ ██ █ ██  █  ████ ████ ████ █████ ████ █ █ █    █ ██   █    ██  ██ █  ██████    ██  █ ███ █   █   █ █ █  ██  ██  ███ █ █ █ ███ █ ██  █ ████ █ ████    ██    ███   █  █ █████████   ██████   ██ █          ████ ██ ██  █   ██ ███ ██     ██ ██   ███ ██ ██
█ ████  █  █  ████  █    █   ██  ██████       █  ██  ██   ██ █   █ █   █ ███ ████   █████  █  █ █  █    ████ ██      █    █ ██ █ ██   █ ██  ████  ███     █ ████    █  ██  █  █    █    ██       █ █  █ ████  ███  ██  ██     █ ██    ███ █    █    █    ██ ████ ███ █ ██  ██ █ █ ██████
█████  █  ██ █  █ █   █ █   █ ██   █ ███ █ █      ███████     ██ █ ████    █ ██  █    █ █  ██  █   █  █   ██ ███  ██ ██ █  ██ █    █   ██  ██  █ ████  █   ██ █     ███████      █   ██   █     █ ██   █ ██ █ ██  ██  █   █████ █       █  █ ██  ████    █     █  ██  █ ███  ██ █  ███ █
██ ███   ██   ██   █ █  ███ █  █  █ ██ █ █  █ █ █   █       ████  █      █  █ █     █ █  ██ ██ ██ █ █ █        ██  ██    █  █  ███████  ██ █  ██ █ ████ ██     █       █ █  █ ██     █  █ █████  ███   █     ██ ██████ █  ████  █ █ ██ █  █       █   ███   █    ██  █   █ █  █████ ████
█ █   ██ ████  ███   █ █    ██         █  ██ █    ██  █  █  █   █ █  █ ██  █ █  █     █   █ ██ █ █ ██  █ ██ █ █  █ ████  ███  █ ████     ██    ████ █  █  ███  █  █ █      ████  █      █ █ ██  █  ███ ████    █   █ ██████ █ █ █  █  █  ██ █ █ ██ █ ██          █ ██  █   █  █   █  █ █
█  █      ████   █       ██   █ ███ █ █ █  ██   ██  ██       █  ██   ██  █  ██████ ██   ██       █ ███ █  █    █ ██ █   █ █ ██  █ ██      █  ██ ██████████   █ █ █ █  █ ██  ██ ██   ████        ██ █ █████ █ █   █████  █      ██ █   █   █     ██ █        █ ██      █ ███  ███ █  █ ██
██   █ ███  █ ██    █     █  ██ ███    ██ ██ ██   ██ █ █    ██  ███      ███ █ ██ █  ██ ██ ██   ███  █  ███  █     ██ ████  █ ███    ██  ██  █ █ ████  █        ██         ███   █ █ ██ █   █   █  ██  ███ █    ███ ██ █ █   █    ██   █   ███ █  █████ █ █   █     █   █   ██ ██ █  █ █
█ █  █ █  █  ██   ███████ █   ███   █ █     █ █ ██     █ █ ███████  █  ██ █  ███   ████  █   █ ██    █ █        █  █ █   █   █ ████ ██ ███  ██  █ █ ███  ██ █  ███ █  █ █ ██ █  ███ ████ ██  █  █  ██ █     █ ██   ███   ██ █  █  ██  █  █  ██ █    ██ █    ██  █ ███ ██    █ █  █ █  ██
██ ██  ██ █  ██ █    █ █ █ █         █   █     ███  █ █   ██ █████      ██  ██  ███    █   █       █   █ ████ █  █   ██ █ █  ███ ████   █  ███  █  █ ████  ████    █ ██ ██ ██   █  █ █████  █   ███ █   ██ ██████ ████ █  █  ██  ███  ██ █      ██ ███  █ ██ █  ██ █    █     ██ ███ █ █
█ █ █ █ █ █  █     █ █ ███  █ █   ██ ██   ██  ██  █ ████ █   █ █ ███ ██  ███   █  ███  ███   ██    █ █ ██ ██ █ █  █ ██ ████ █   ██ █ ██  ███ █ █ █   █     ██  ████    ██   █  █    ██    ██  ███  █ █      █ █████ █ ██  █ █ ███ ██  █       ███ █ █ ██  █ ██ █   █ █    ██ ██   █ ████
██ ██   █   █  ████ █   ███  ████     █    █ █ █████  █ █    ██████ █  █  ██  █ ███ ██      ██      ██   █ ██ █  █ █  ██ █ ██  ██ █ █ █ ███ █  █ █ █ ██ █      ██ ███  █     ██████ █ █    ███ ███         █   ██ ██ █     █ ██   █  █ █   █ ███ ███   █ ███  █    █        █   ███ █ ██
██  ███   ██████     █  █ █ █ █ █ ██  █     █ █ █   ██ ███ ██    ███    █ █  █  ██   █   █    █     ██ █     █         ██  ██    ███   █████ █  ██      ███    █             █    ███  ████ █  ██ ███ █ ██   ███ █  █   █  █  ██ ████ ███ ██ █ ██ █ █ ███   ██    █ ██████  █  ██ ██ █ █
█ █ █  █████  ███      ███ █  █         █   ██  ██  █████ ██    ██  ███  █  █  █ ██████   ██  ██ █  ██  ██ █ █   ███  █ █ ██  ████  █ █ ███   ██ ██      █  █        █   █  █   █ █ ██   ████ ██ ███ ███ ██  ██ █   █████  █   █    █ █████    █  ██     ███ ████         █ ██████    ██
███   ███ ██    █      █████   █     ██ █  █  █  █ █  █ ███ █ ██ █ █ ██ █ █ █   █ █    ██ █  ██ ██  █   █████    █ ██   █ █ ██  ████  █ █   █ ███ █ █ ██      ██  ██      █  █   ██  █ ████ █    ██████  █ █ █ █ █   ██      ████    █     █     ██ █   ███ ██     █████    ██  █    ███
██ █ █  █     ██ █   ████     ██   ██ █ █ █   ██ █ ██ ████ █ █     █     █ █ █ ███ █   █  █  █  █  █ ███ █ █ █  ███ ██   █ ████  █ ██  █     ████ █ ██   █ █  █ █ ██   █ █  █  ████ █ ██████        █ █       ██    ██   ██ █ ██ ████  █ █ █ █   ██   ███   █      █  ██ █ █      ██   █
███ ██ █      █ █ █   █  █ █   ██ ████ █          ███ █   █ █ ██   █      █     █  ███  █ █ █  █ █  █ █ █ █   ███████ ██ █ ███    █  █   █   █      █  ██ ██████    █  █ ██       ██ ███ ███       ██████   █  ███ ███ █ ███ █ ██  ██  ██ █    ██  █ ███  ██ █  █ █  █ ███ █  █     ██ █
█ █  █████    █   ███████     █ ██   █  █  █   █████    ██  █ █   ████ █ ██   █ █  █  █  █  ██   █   █  █  ███ ██     █ █  █ ██ ██  ███ ███ █ █   █ █  █  ██ █ █  █    █   ███ █ █    █  ██ ██ ███ █   █ █ ███ █ █  █ █ █   █  ████████  █ █  █ █ ███ ███  █ █ █   █    █  █  ███ ███ ██
██       █        █  █     ██   █ ███ █████ █   █ ██    █       █████ █   ██ █  ███   ██     ██ █ ██  █ █ ██  ███  █ ██ █    █ ██  ██████   █   ██  ██ ██ █ █        ██ █  █ █     █  █ █ █ ███    █      ██████   ██████  ██ ███   ███ █ ██████ █   ██  █ ███ ██  █  ██  ██ ██  ██ █ ██
█   ███  █  █  ███ █ █████  ██ █   █  █  █ █  ██ █  █  █ ██████ █  █    █    ██ ███████ ███   █   █ █    █   █  █  █  █   █████ ██ █ ██ █   █ ██   █ █     ██  ████   ██ █ ███  ███ ████   ██    █   █ ██  █ █     █   ██ █    █ █   █ █ ██  ███   █  █ █   █ ███   █  █ █         █   █
█ █   ██  █ ██ ██  █    ██  ██ ███    █   █    █    █ █  ██ █   ██  ████ █ █  █   █      ████   █ █ █ ██   █ ████ ███   ███ ████ █       █████        █   █ ██   █ ██████ ███   █ █ ████ ██ ███     ██   ███   ██ █ ██████   █  ██ █ █ █ █   ██ ██ ██    █████  ███   ████  ███     █  █
██  ██ █ █ ██  ██    ███ ██  █    ██   █  █ █ █ █  █████ ████  ███ █      █ ███████████ █  ██  █   █     █     █ █   █ ████ ██        █   ██ ██ █      ███ █  ██ █ █   █  █    ████ ████    █ ████       █    █    █  █  █       ██ █ ██  █████     █ ██ █  ██  █ █ █  █  ████ █ █  █  █
█         █      ███████    █    ███ █ █   █  █ ██ █  ██     ██ ██████  ██    █     █   █████   █ █ █  █     █ █  █   ███   ███     ███ ██  █  █ ███ █   ██ █ █  ██  ██    █ █ ██ █ █       ██ ██ ██ ███  ███ █ █  ██ ███      █ █ █  ███ ██ █  ████     ███ █ █  █     ███ █ █ █  ██  █
██     ███    █ █  ███   █  █ ██      ████  ██ █    █ ██   ██   █   ██ █ ███ ██   █  █  █ █ █   █  █   ████ ██ ███  █ █ ██  ████  ██ ████ █ ██  █ █      █ █ █   █        ████ █    ███  █   █  █ ███  █ █   █ █  █ ████ █       █  █  ███ ██  ███    █   █ █ ███    █      ███  ███   █
█ █ ███ █ ████ █  █  ██ ██ █ ██   █  █████ ████ ██   ██████ █  ██   ██  █   █ ██ █ ███  █████ ██  █  ███       █ █     ████ ██   █  █  █ █  █  ███  ████  █  ██  ██  ███           █ ██       █ █     ██ █ ██   █ █  █  ██  █████  █ █  ██   █ █  ████  ██     █     ████ ██ █    █ █  █
█   █       █ ██     ███   █ ███  █ █    █ ██ █ █    █  ██ ██ █  █  █ █   █   █ █      ██  ████ ████  █ ███ █  █ █ ███ █  █   ████  █  ██ █ █ ██ ██   ██ █  ██████  █████ █ █    ███   ███    ████ ██   ██  █ ██  ██  ██  ██ ██ ███       █  █ █  ██  █   █  ██ █     ██████     █     █
██ █    ███ █  █    ██    ███ █      ████ ███ ███ ████  █  ███ █ █ ██ █    ██ █ ██████       █ ███ █    █     █ █ █  ████ ██  ██  █ ███ █ ██ █ █ ███    ████ ██ █  ████ ██ ██ █  █ █      █  ██ ██ █   █ █    █   ██ ██ ██     █████ ██████  █    ██ █ █ ███  ████ ██ ██ █ ██   ██ █████
█ █    █ █   ██ ██ ██ ████ █     █ █ █    █     █ ██████ █ █  █  ███   █ █ █  █  ██ █ █ ██ █  ██   █ ██    █  ███  ██   ██  ███  █ █  █  █████ █    ██  ██ █ ███      █  ██      █  █    ███ █  ██     ██ █  ███ ███  ██ █ █  █   █ ██  █      ████ ███ ██ █   ██  ██ █ ██ ██    █ █  ██
█  █ █ █   █ ██ █   █  ██  █ █   █ █  █ ███    ██ ███ █    ██  █   ███   █   █ █     ██  █    █  ██  ██ ███  ██       █  ██ █ █   █ █ █   █ ██     █████ █  █  ███ ██ █ █  █ ███    █  █  ███ ██   █████ █     █ ██  █    ██    █   ██████  ██ █ ██      ██ ██  ██     █  █ ██ █    ████
███   ██   █  █ ███   ███   ██ █  ███ ███ █ ██████  █ ██ ██ █ ███ ███    █   ██    █   █    ██ ████  █    █  █    ██ █ ███   █  ██ █  █    ██ █   █   █████ ███   █   ██ ███ ██   █    ██ █ ██ █  █ ███ █  ████  ██ █ ███  █  ██████      █  █ ██ █ █ █ ██  ███ ████ █  ██ █ ██   █  █ █
█   █  █  ████  ███  ██       █ █   ██         ██ █  █  ██ █  ███ █  █   ███ █  █ █         █  █  ███  ████  █ █  ██ █  █  █ █ ██     █ ██    █    ████   █  █    ████ ██ █    █   ███ █ █ ██ █  ██ █ █  █ ██ ███ ███  █  █   ██ █   ████   █     ███  ██ ██████     █      █ ██ █  █  █
█   █   ███ █ █ █  █ ██ ████ ████  █ █ █ █     █      █ ██   ███ ██ █    ████  █  █  █   █ █    ██  █     █ ██  █  ███     █      █   ████  █   ██     ██   ██  ██ █ ███    ██      ██    █  ██    █ █   █   █ ████      ██    ██ █  ████ █ ██    ███    █     █ ███   █ ██ ██████ █   █
█      █     ██ █ █ █ █ ███  █ █ █  █  ██ ██ █ █   █    ███ █ █ █  █ █ ██ █  ██          █ █     █ ██    █  █ ██     ██      █ █ █ ██   ██ █  █   █ █  █ ██ █  ██ ███    █████   █   ███            ██  █    █ ██       ██ █ ██  █████   █ █    █   ██ ███    █   ██  █████    ██  ███ █
█  █   █  ██   █  █ █ █████ █   █   ███  ████      █ ██       ███    ██   ██        ██ ████     █ █ █  █ █ ███ █ █ ████████ █ ██ █    ████  █   █  █ █  █ █████  █  ██  ██  ██ █ █ ████  █   █ █     ██ █  █████ ██       ███   ██████  ███ ██     ███    █████ █ ███   ████  █ ██  ██ █
██ ███████  █   ███ █   ██  █     ████ ██    █ ██  ███   █    ███  █ █ ██ ██   █   ██ █  █      ████ █      ████ █ █ █ ██████ ███ █  █  █   ██ █  █ █ ██ ██  █ ████ ██      █  ████   █     █  █ ██     █   █   █    ██  █  ██ █    █████  ███████   █  █ ██ ███████  █ ███ ██  █  █████
█████ ███  █ █  ██  ████    █    ██ █████████    █████  █ ██   ███  ██ █ █ █ ██ ███       █  █ █        █ █  █  ██ █  █████ █ ██████   ██████ █  █    █    ██   █ █ ██   ██  █████ ██      ████     █  █  █ ███  ██ ████  █   █  █ ███   █ █ █ █ █ ██ ██ █ █ █      █  █ ██ ███ █   █  █
██ ███     █ ██     █  █  ███████   ██ █  ██  ██  █████  ███████ ██ █  ██ ██ ███ █ █    ██ █ █    █   █ ██   █ █    ███ █  █   █ █  █ ██    ████████ ███  █ ████ █      ██  ███  █ ████   █   ███   ██  ███    █ █ █ ██ █     █ █       ██ █    █  █ █     █ ███ ███ ██  █    █ █  █ █ █
███   █      █    █ ██  ██   ███    █    █  █  █  ██   █      ██ █       ██ ██ █ ██  █  █  ███ ██   █  ███ █████    █    ██  █   ██     █  ██  ███   █ █   ███   █ ██     █ █ █    █ █  ██          ███ █    ████ ██  ██  ██ ██  ██  █   █    ███  █       ██  ████ █ ██ ██   █     █ ██
██ █████  █ ██   █   █  ███ █      ██ █ ██ █ █ █    ██ █ ██ ██  █ ███  █ ██ █     █  █ ███ ██ █ ██    █  ████        ██ ███ ██  █ █████ ██   █    █ ██  █  █  ███  █ █   ██  ██ █  ██ ████  ████             ██     ███   █   █       ███  █  ██    █     ███  ███   ██   ██ █         █
█ █ █ ██ ██   █   ██ █   █ █ █   ██  ██ █ █  ██ █  ███  ██  █   █    ██   ██ █ ██   █  ████  █  █ ██       ██  █████   █  █    █ ██  █   █ ██    ██ ████ █   █  ██  █      ███ █ █ ███ ████   ███   █  ███ █   ███ █████      █     █████        ██         █ █  █  █ █   █  █  █ ███ ██
██   ██  █ █ █   ███ ██    █ █      ██  ██    █ ███ ███  ████  █ ██ █  ███   ████  █████  █  ███ █  █ █ █   ████ █ ██ █    ██  █ ██  ███      ████  █  █ █ █  ███ ██   █  █████   █  █    █ █ ███ ███ █ █      ███ ██    █ █     ██   ██ ████ ███    █  █  █ ██ ██ █  █████  █     █ █ █
█ ██ █     █   ███  █ ███    ████  ██  ███  ██ █ █ ███ ██  █  █ █ ██ ██ ████   █ ██ █  █  ███   ███ ███   ███   ██     █  █  ██  ██  █  █ █ ███       ███ █ ███ ███      █  █ ████  ██████ █      █  ██ █    ████  ███   █ █  ███      █   █  ██ █     █  █   ███     ██ ███ █    █    █
████  █ █ ██ █  █         █  ███   █ █ █ █    █████ ██ ████    ███  ██ █ █  █ █ ██ ██  ███  ██ ██ ███   ████ ██████    █ ██  ██ ███ █ █ ███  █      █ █   █ ██       █ █   ██ █ ██ █   ██   ███  ███ ██ ███ █████ █   █ █ ██  ███   █ █ █    █  █ █ █ ██ ██  █ ███  ████████   █   █  ██
████   █ █ █ █ █  ██  ███████ █   ██  █ ██  █        █  █    █  ██ ██  █  █ █   █ █ ██ █ █  ██ █    █ █ █ ███  ██      ██   ██ █ █ █████   █   ███    █ ██████ █ █ █ ██████  █ ██ ██       ████  ████   █ ██ ██   ██   █ █     █ ██ █ █    █ █ █  █ ██ █     ██████ █████ █         █ ██
█   █ █      ██ █   █ █ █ █████  ██ █ █ ██   ██ ██  █     ██ ██ █  █ █ ███   █  █    ██    █   █  ████ ████  ██ █  ██ █  █           █ █ ████    ██  ██ ██ █ ██████ ██   █ ███ █ █ █  ██████    ███  █ █ ██    ██ ██      █████  █ █    █  █ █ █   █ █  █ █ ████ ██ █ ██ █  ██   █ ██  █
█  █    █  █     █    ███ █  ███      █ ███  █ █      █ █   ██    █ █ █   █   ██ ████ █     █  █ ██ ██ █ ███  █ █ █    █ ██ █   █  ██  ██     ████  █     █   █ ████  █ █ ██     █     █   █ █ ██  █     ████ █ █ █  ██████ ██    █   ██     ██ █  █ █  █  █  █ █ █ █  █ ███ ██   █ ██ █
█ █ █ ███████   ███ █      █  █  ███   ██ ████  ██ █  █  █       █ ██  █    ██ ███ █ █  █     █    █ ██  █ █ █ ██   ██     ██ ███  ██ █ █   ███  █   ██ ██  █   ██      █  ██ ████    ██████ █ █  █ █ █  █   █    ███████  █ █████   █ █       █  █       █  ██     ██   ███ █  █ ██   █
█ █████ █ █  ██ █     █  █ █  ██    █  █ ██ ██ █   ███     █  █      █ █  ███  █      █    █ █ ████  █ █  ██   ███ █  █ ███ █ ██  ██ █   █  █   ████ ██ █  █   ██   █        █       █ █ █████  █ █   █    ██ █ █ █      ████ █ █  █ █    ███  █ ███   █ █ █ █  ██    ██ █    ████     █
█████   █████ ██   █   ██ ███ █ ██ ██ █ █   █   ████ ██   ███ █ ██   ██  ██ ██ █  ████  █   █████   ██ █  █   ██ ██  ██    █ ██  █ ██████   █         █   █     █ █ █    █   █     ████  ██ █ █  ██   █  ██ ████ ██   ██████ █  █ ██  █       ████  ████ █  ██    ███      ███ █ ███   █
█   █ █  ██████ █ ███  █  █ ███████      █ █ █ ██         █ █ █   █ ██ ██ █   ███ █   █  █  ███  █ █ █   █ █  █ █    ██ █ ██   █ ███  ██ █  █  █   █   █ ███ █    █  ██   █  ███   ██ ██    ███  █ ██ █████ ███ █    ██   ██ █ ██████ █   █   █       ██ █ ███ █ █      █ ███ ███  ███ █
███    █     █ █ █ ███ █ ██        █ █ █ █ █  █   ██ █ ██ █ █   █  █    █   ███ █ █  █ ██    █ ██      █  █████ ██ █  ██  ██ █ █ █    █ ███  ██ █       █ █     ███    █ █  ███  █   █ ██ ███ █ █  █ █ █ ███   █   █  █ ██  ██  █ █      █   ██ █ █  █ █  █ █   █ █  █  ████ █ █  █ █  █
██   ██  █    ████ ██     █ █ █████ ██ ██ ██  ██ █   █   █       █           ██  █ █ ███ █  ██ █ ██ ██ █ █ ██    ███ █ ██  █   █   ██ ████   █ █████████ █ █        █     ███ █ ██    ██ ██    ██  █  █  █     █  █   █ █ █████ █ █  ██   █    ██  ██ █     █     ███  █ █ █ █   ██ █ ██
█     ████  ██ ██     █ ████ █  ████  ██    ██ █   █ ███  █ █ ██ ███   ██  █     █   █     █ █ █ ██ █ ███  █  █  █ ███    ███     █  █   ███   █ ██     █ █  ██  █ █ ███ █ █   █   ██ █ ███ █  █  █ █ ██         █ █ ██  ██████ ██  █ ██  ██     █ █   ██      █ █      █ █████ █    █ █
█  █  █  █  █████  █  █    ██     ███  █  █     █   █  ████    ███ ██ █  █  █    ██ █  ███  ██   ██   █  ██    ██  ██ ██ ██  █    █   █ ███  ██ █     █ █  █    ██████ █  █ ██ █ ███  ███    █    █ █  ████   ██   █ ██   █ ██ ██████ ██   ██ ██    █  ██   █ █ █ ███    █  ██  ██████ █
█  █ █  ██ ██ █ █ █      ███ ██   ██ ██ █     █  █  █ █   █    █ █    █     █  ██  █ █ ██ ██    █     ████ ██   █ ██ █ █  █  █   █ ██ █       █ ███  ███ █          █ █     █  █ █   ██  █  █  █ █  ████   █ █  ██ █  ██     █ █ █   ██    ████ ██ █  █ ████  ██ ██ █ █ █    ███ █████ █
██     █  █  █    █ ██    █████   ███     █ █████ █   █████   ██   █ █  █ █████ ██ █  █ ██  ███    █ █ █   ██ ██   █ █  █ ████ █  █ ███  █  ██    ███   █ ████  █  ███  ██ █   ██ █ ███       █ █████ ███ █ █ █ █████   ██ ██   ███  ████ ██  █   █    █ █ █ ██ ██ █    █ ██     ███ ███
██  █ █      █████ █████  █   ███   █ █  ██ ██ █  ██    █  ████ ██ ██    ██  ██ ███ ██  █ █     █  █        ██ █ ██  ██ █  ██  █  ██      █ ███     █ █   ████  █ █   █ █ █ ██ █   ███████    █ ██  █    ██ ████   ██ █  █  █ █ ███ ███  █ ██████████ █    ███ █ █ ██  ███ █ ███  █    █
█ ████ █  █  ██ █ ██  █   █ █  █    ███ █ ██     ██   █ █       ██    █ █ █   ██         █  ██  █  █ ██ ██   █  █  ██ ██ ██ ██   ██   █  █  ███ ██   █ ██ █ █  █ ███ █         █     ████   █    ██ █     █ █ █ █  █     ██   █     ███ █   █ █ ██  █   ██  ██ █     ███  ██ █  ██ ██  █
█ ███   ██ ██     █ █  █    ██████ █  █  █████         █ █     █  ███    ██ ██ █ ██   █ ██    █  █ ███      ████ █  ████████ █ █  ██ █      █   ██   █ █   ██  ██  █ █  ██   ██   █  ██  █  ███   ████ ███    ██  █   ███ ██  █    ██  ██ █ █ █████  █  █ ███     █  █    █ █     ██   █
███    ██ █   ██ ██     █  █  ██     ████ ██ █ █ ██ █     █ ██   ███ █ █ █ █      █        ██ █ █ █ █ ██ ██  █  █ █   █    █ █ █ ██ ██ ██  █ █  █  █████   ██   █ █     █ ███      ██ █ ██ █     ██    █████  ██  ██ ██ ████ ██   █ ███ █  █   ██ ██  █     █ █  █  ███ █     █ █████  █
██  ████ █ ████  █ █  █  █ ██ ████████  █  █ ██ ██     ███ ███   █   ████ █████   ████        ███████ █ █   █ █ ███ ██ ██   ██  █ █    █ █   █    ██ █ █  █   █ ██  ████  ██   █ █  █████ █   █ ██  █   ██ █ ██   █    █ █ ██ █████ █  █ █ ██ █ █ ██ █ ███     █ █  █   ██ ██ ████     █
████████████████████████████████████████████████████████████████████████████████████████████████████████████████████████████████████████████████████████████████████████████████████████████████████████████████████████████████████████████████████████████████████████████████████████
