████████████████████████████████████████████████████████████████████████████████████████████████████████████████████████████████████████████████████████████████████████████████████████████████████████████████████████████████████████████████████████████████████████████████████████
█    ██  █  ███      ███  █ █   ████   █ ███      ██  ███ ██  █     ██ ████  ██  ██  █    ████    ████   █ █ █ █ ███  ██  █ █ █ █  ██  ██   █   █  █ █ ██ █ ██ █ ███       █  █    █   ██ █ ██ █   ██     █   █  █ ████  ███   ██      █ █   █ █   ███    ██  ████  █ ██ █ ███ ███ █ ███
█ ███ █ █     ██    █  ███████ ██ ██ █ ██  █ █ █ █  ██    ███ █ █  ██  █  █   ██ ██  █  ██      ███     █ █ █ █ ██ ██ █ █  █ ██   █     █ █   ██ █  █  ███     █ ███ █ █   █ ███  █     ███ ███   █   ███   █ █ ████  █ █ █  █ ██ █     ██ █ █ ██ █   █ █████   ██  █ █             ████
████     █  ████ ██  █   █ █ ██  █  █   █   ███ █ █████████   ████         █ ██ █   █████    ███  █ █  █  ███  █  ██ ████  █ ███ █  █   ██ █ ██  █ ██    ██ ██   ██████ █ █       █  █ ██   ██   ██ ███ █ █   █   ███   ███     █  █ █ ███ █   █  █  █ ██ █   ██  ████         ██ ██   █
███   ██  █           ███ ██   █  █ ██     █ █ ██     ████████    ███  ███   █     █    █      █ █  █      █   █ █   █    █ ██    ██  █  █ ████  ██   █   █  █ █ █   █   █  ███  ███ ██ █ █████ █████ ██    █    ██ ██  ██ ██ █ █  ███ █  ██ ██      ████ █     ██ █   █   █ █   █ ██ ██
█        ██  █   █ ██   █ █ ███ ██  █   ███ ███   █  █ █    █  ██ ████   █    █ █  █ █ █   █ █ █ █ █ ██ ██  █ █ █    ██ █  ██  ██ ████  ███ ██ ███ ██  █ █    █ █   █    █           ██████ ██         █  █    ████   █ ████████ █ ██   ██ █   █████████  ████████   █ ██ ██ █ █   █   █
█   ████ ███  ██ ███  ██    ██████ █ █ █     ███ █     █  █ █ █   █    ███████ █    ██    ██   ███ █  ██   █   █ █   █ █ █ █ ██ ██           █  █ █  █    ██      ██  ██ ██   ████ █ █████   █ ██  █ ███ █ █  █     █  ███    █ █████ ██ ██ ████  ██ █ ███    █   ██    ██  █ █ █  █   █
█  ███       ███   █ ████    ██ █ █  ██ █   █ █ █ █   █   ██ ██ █  ██ █ ██ ██  ███  █  █ █  ██  ██   █   ██ █ █  ███ █ ██ █ █   ██  █ █████   █████     ██     ██     █ █  ██ █  █    ██ ███  █          █ ███     █     ████ ██ ██ █ ██     █ █   ██████  █ █   █ █   █ ██   ███████ ██
██  █ █  ███  ██ █    ████  █ ██ ██  █ ████  █ ██      ███ █ █  █ ████ ██  █████ ██ ██     █ ██  █ █ █ █      █  ██     ██████  ████ █ █  ███ ████     ██   ██ █   █     ██ ██ █  ██  █ ███  █    ██  ███ █ ██ █ █ ██   ███  █    █ █     █  ██ █  █ ██   █ ██  ██  ███ █ ████   ███   █
██ █ ███ █  █   █     █████   ██ ███    ███ █  ██  ████ █ █ █   █          ██ ██         ██ ██    ████  ██     █ █   █  ██  ██      ██     █  ██ ████     █   █     █  ███  █      █ ███ ██   █       █ █   ███ █    ███      ██ █  ██ █  ██  █ ██ █ ██ ████     ██ ██ ██    ███  █ █  █
█ █ ██ █████         █   █ █ █ █   █ █  ██ ████    █████  █ █ ██       ███ █  █      █   ███ █  ██████  █    ██    █   █ █  █ ██       ██         █  ██  █ █    █ █ █ █  █    █ ██ ██ ██      ██  ██  █ █   █ ███  █ █       █   █ █ █  █    ██   █ █ ██ █  █████ █ █   █████    █████ █
█    █  █ ██            ██       █ ███ █ ██   █    ██ █     ████   ██  ███        █ █ █ █ █ ████ ██  ████ █     ██    █ █ ██████████  ███  █ █  ██ ██   █ ███████ ██ ██████  ██     █ █  ████ ████  ████    ██ █████ █  █   █ █  ████ █ █ ███ █  █    █    ██   ██  ██ ██ █ █ █████   ██
█ ██  █     █  █  █ █ █    █ █   █  ███ █   █ ███ ██  ██  █    █ █  █  █  █████████ █ █ █ █  █          ███ ████  █ █  █ █     ████   █ █    ██  ███████  █ ██           █████████ █ ███ █████ ██ █  █  ███ █ ██   ████ █  █ █ █   ███   ██  █ █   █ █  ████  ██████    ██   █ █     █ █
█ ███  █████ █████ █    █ ██    ██ ██ █  ████        ██ ██   █   ██████ █ ██   ██  █ █ ██ █ █   █  █     ██ ██   █ █ ██   █  ██ ██ ██ ██ ██    █  █   ████ ██       ███  ██  █ █ ██   ██ █   █████   █ ██    █     █    ██ █ ████ █ ██   ██     ███  ██   ███ ██  ██     ███   █ █  ████
█  █ █  ██   ███   ██ █     █  █ █ █  █ ██ █   ██ ██   █████ ██  █  █  █  ██  █   ██████  ███ ███ █   ███   █ ████   ██ ██ █  ███    █  █ ██     █ ██  █ ██  █  ██   █    ███ █     ██  █ ████    ███ █    █ █      ███   █   █   ███   █       █ █   ██      █  █   ██  █ █     █ █   █
█ █  █   ██   █      █    █    █    █    █ █  █ ██  ███      █ █████ █  █  █   ██ █  █  █   ███ ██      ██ ███ ██  ███       █ ██ █ ██ █ ██████ █     █      ██ █   ██  █      █ ███  █ ██   █   █   █    █ █ █ █   ██ █ ██   █ █   █    █       █  █ █     █   █ █   ████     ███ █   █
███ █ ████   █  █ ████  █        █ █ █      ██   ██ █ █ ███  █  █      ██    █  █  █ █   ██    ██     ██  █  ██  █  █ █   ███    ██ █  █ █████   ██   █  ███  █   ██     █ ██ █    ████ ████████ █  ███  █ ██    █  █ ██ ███  █████     █ ██     █ ██  █ █  ████  █  █ ███   ██  █     █
██ █   ██ ██  █████     █   ███ █ █ ████   ██ █     █     ██ █ ██ █ ██ █ █ █ █ ██      █ █ █ █ ████   █ █    ██    ██  █  █      █  ██      █  █    █ ██  █  ██     █  █ █  █   ████    █ ██  ██        █ ████    ██         ████ █   █  █      ███ ██ ███ ██ ██  █   █████ █ █   █   ██
███      ██   █  ██  █ █████ ███ █ █ ██ ██  ██ █  ███ █ █ █  █   █ ████████  █   ██ █   █ █ █ ███ ███ ██   ██  ██  █ █   ███ █    █ █     ████ ███ █   █ ███ ██     ██  ██        █ ██ █   █ █ ██ ██  █ ██ █ ██ █   █   ██     █   ██████    ██    █ █   ███████ █ █ █ █  ███ ███ █ █ ██
██ █ █   ██ ██   ██████ █  █  ██ █ █ █     █████     █   ████   ██     █ ██   █ ████  █ █ █           ████ █ █   █    █  ███    █   ██    ██   █ █ ███  █   █  █ █ ███ ████ ███   █ ███    █ █  ██   █    █ █    █ █ ██ █   ██   █ ███ █ █ █ ██  █   █ ██  █ ██    ██  ██     ██       █
██ █     ██ █   █    █ █    █   ██    ████ █ █ █   █ ██  ██          █     ██  █   ██  ████    ████ █  ████  █ ██   ███ █  ███   ██ █ ███ █    ██ █ █       █ █ █ █    █ ███ █   ██  ██  ██ ██████  █ █ █     █  █ ██    █   ████  █ ██  ██ █  █ ██  █   ██ ██ ████ █ ██ █ █  ██     ███
█████   ██ █ █   █████  ████████ █      █ ██   ███ █      █   ██  ██  ██      █ █  █  █           █ ███████   ████ █    █  ██ ███ ████   █  ██     █   ████ ████  ██ █  █     █     █ █     █ ███ █  █ █ █    █████ ███  ██ ████     █ █  ██ █  █ █     █  █ ██ ██  ██████ ██████ █  █ █
███    █    █     ██    █ █ █  █ █    █ █  █ ██ █     ██   ████  █    █    █ █████  █  █  ██   █   █  ██      █ █       █  █ ████ █ █ ██ █ █ █ █ █ ██   ██     ███ ██ ███ ██  ██   █ ███ █ █  ████    █ █ █  █      ██   █████  █ █       █    █        █ █  █████ █ █ █   █    ██     █
█ █ ██ ██  █ █  █    █  █ █ █     █   ███ █  ███    ███     ██████ ███  ██  █   █ █ █ █ ██   ██    ██    ███   █    ██ █ █   ███ ██    ███ █  ████   █   ██  █ █ ██████      █  ███   ███ █ █  █ ██  ██    █ ██    ██    █       █      ████   █   ██    ███ ███ ██  █   █ █  ██ █   █ █
██    ██  █      █ █ █ ██ █    █ ███   ██ ██   ██ ██  █   ███    █ ███      ███  ██   █ ██  ██ █    ███ ███ ██   ████ ████ ████████  █   ██   █ ██  █ █     ██ █   ███      █   █ ███  █ █   ██   █ █ █  █████  █  ██████       █ █   █ ███   ████  █ █   ███ █         ███  ███  ██ ███
██ █  █ ██ ████ ██ █ █████ █  █ █ ████ ██     █  ██  █ █   █████████████   ██ ██ █ █ ███     █  ███   █ ███ █ █  ██  █   ██    █ █  █  █ ███  ███  █ █████    █ █ █ ██ █ ███  █  █ ██   ██   █   ██  ██ █        █ █  █ ██   █  ██   █ █   █     █     █  █ █ █ █ ██    █   █   ██   ███
█  █ ██  ███ █   █      ██ ███   ██   █ ██ █   ██ █  █████   ███ █   █ █     ███    ████ █    ██ ███  █  ████ ███   ██ ██ ███ ██ █ ████ █  █ ██  █ █  █  ██ █████  █  █ █  ███  ██ █ ███ ███  █   ██    █    █   █ █  ██ ████   █  ████  █   ███      █    ██████ █ █ █  █ ███  █  ██  █
█ █ █   █   ██ █  ███████   ██  ███ ███ ████  ███  ███ █ ██ █    ██     ███  █ █    ██  █    █ █  █    █  █       █ █ █   ██  ██   ██████ █  █ ███  ██ █     █ ██████  ██  ████ █ ██  █  ███   █ ███  ███ █ ██  █   █ █  █ ███ ██  █         █  ███████  █      █  ███ █  █ ███    ███ █
███ █ █ ██ ██ ███ ██   █    ███ █     ██    █ █     █   ██  █   ████  █ █ ██ █████       ████ ██  █    █ ████    █  ████     █      ████  █   ███   ██ ███    ███ █     ██ ████  ██ ███  ██    ██  ████    █ ██ ██ █ ██ █ █████ ██ ████ ████   █  ██      █   █      ██    █ █ █  █  █ █
█ █ ███       ████  ███ █  ████  █  ██ ███ █  █ █   ████ █ █████  █  ████  ██ █  █   █   █ ██ ███  █████ ███ ███    ████ ██   ████   ███  ████ ██     █  █    ██     ██ █  ██ ████ ███ ███      █ ██ ██ █  ██   ██  ██   ██   ██ █ █  █    █ ██  █ █████         ██   █ ███ █       ████
██      ██ █ ██     ████  █      █    ████ █  █ ██ █      ████  █  █ ███  ██    █  █ █  ██  █        █████  █ █   ███    ██  ██ █   ██ █    █      █    ██ █   █   ██  ████   ███   █████ █ ██ ██ ██ ███    █ █ ███ ██ █     ███  ██  █    ██   ██ █   █ ██  ██ █   █ █ █  █  ██  █  ███
█  ██     █  █ █   █    ██ █   █ █ ██████ █████ ██ ██ ██ ██ █ ██ ███ █ █   █ ███ ██ ██   ███  █  ██    █   █  █  █ ████   █████ ███   █   █ ██       ████ ██  █ █  ███ ██ █ ████ ██     ███   ██   ██   ██ █       █   ██ █ ████████  ██      ██ ██ ████  █ █   █ █   █ ██  █   ██ ██ ██
█      █   ██  █ █       ██    █  █   ███ ███ ███ █ ████ █ █ ██  ██ ████   █  ██  ██ ████ █ █ ███ █      █   █ ██ █   █      ██   ██ ███  █     █ ██ █ █  ██ ██ ██ ██  █ ██  ██ ██    █  █ ██████  ████    █  █  ██   ██   ██ █ ██  █  ██   █████    █   ██ █   ██ ███ █ █    █   ███  █
█  ██ █    ███  ██   ████  █   ██  █████████ ██  █  █  █      █ █ █  █ █ █ █  █ ██  ██ █     █ █   █  ██  █    ██ █   ███ ████ █   ██  ████ █    ███ ████    ██ █ █ █    █ █ █      █   █     █     █ █    █ ██  ████  █  █   █ ███  █████  ██  █ █  ███  ███   █  █ ███ ██  █    █  █ █
█ █  ███   █   ███  █ █████   █    █ █  ██ █  ██   ██ █ █  █ ██  ███  ████  █    ██   █   █ ███  █ ██ ████ █ ████ █   █   ███  █ ███ █    █  █ █ ██    ████  █   █   █   █ ███ █       ████  ███  ██ █     ██ ██  █     █  █ ██  █    ██  ████   █          █   █     █    █  █ ██   █ █
███  █  ██ █  ██  █      ██  ███ █  ██ ███      █      █ █ █ █   █ ██ █████  ███      █    ██  ███   █ █ ███ █ ██ █ █████ █ ██  █ ██  █   █    ████ ███  █  █ █ █ ██████ █    █  ████ █      ██  █  █ █ █     ██ █ █  █ █ █  ████████ ██    █ █ █ ███████ ███ ██   █  █ █ █      █   ███
██ ████ █  ██  █ █ █   ███ █  ██      █ ██ ███ ██  ███ █ █ █  █  █ █   █ ██ ██ █   █    ████ ███  ███    ██ ██  ██ █  █████  ████  █ ████ █ ████ █           ███ █ ███   █  ██  █      ██ ██  ██   █   █  ██████ █    █   ██  ██  ███   █████   █      █ ███  █  ██     █ █ ██  █    █ █
██ ████ █     █     █ ███   ██  █  █     ██ █ ██    █  ███ ██    █   ██ ██ ██  ███ █ █  █ █   █    █████      █  █ █ █ █         ██████████  █  █ ██  ████  █ █   █  █    █   ███  █    █  █ █   █  █  ██ █    ████ █ █ ███ █             █  ██   ██   ███  █  ███   ██ ████  █  █    ██
███ █ █ ██  █   █           █   ███ ████    █ █   ██    ███  ██    █ ██ ██   █       ███  █ ███    ██  █ █ █    ██ █ █ █ █ ███ ██   █  █  ██  █    █  █  █  ████ █  █ █ █ █    ███   ██ █ █  ███ ██ █   █ ██████ ██ ████ █       █ ██  █   █  ██████     █ ██ ██      █   ███ ███  ██ ██
█ █  █  ██ █ ██ █  █ ████   █  █ █  ███  ███   █ ███     █    █  █ █ ██  █  ███  ███ █ ███ █  █ ███ █   █   █  █ █ █     ████     ██ █   ████ ████   █ █     ██ ████ ██ █ █  █  ████ ██    ██ █ ██ █     █  █████    █  ██      ████   ██  █ █   ██   █   ██ ██ █   █ █    ████ █  ██ ██
█████          ██ █████████ █  █   █   █  █   ██   ██        █ █  █  ██  █   █ ███  █  █    ███ █  █   █ █████ ███    █ ██ █████ █████ ████ █    ██ █   ██   █   █  ██ █  █ █ ██   ██ █  █ █ █ █████ █   ██ █  ████ █    █  █████  █     ███  ██  ██  ██  █    █  █   █  ██ ███ █  ██  █
███ █  █   █     ██    █ ██ █ ███ █  █ ██ █ ████████  █   █████  █ █ ███ ██ █    █  ██   █ ███ █   ██ ██  █  █ ███████  ██ █ █    █   █   ██ ██   █ █  ███  █  ███████ █   █    █    ██    █ ██   ██ █  █  █ █ ██   █ ██ █  ██ █ ███  ████    █    █ █    █ █  █ █   ██ ███ ██ ██  █   █
█ ██   █ ██ ██ █       █    █      █  █ █ ██   █ █   ██ █ █ ███  █  ███  ███   █ █ ██ █    █    █ █  ██  █  █ █   ██ █████ ██    █ █ █    ███   █      ███ █ █ █  █ █ ██   █    ████  █ █ █  █    █  ██  ████ ██ ███    █  █ █  █  ████ █ █   ██  █   ██ ███    ██ █  █  ████ ██ █  ██ █
████  ██        █ █████ █ █  █ ██ █   ███ █ █  █   ██ █ █  █ █  █ █  ██ ██    ██ █   ██ ███  ██  █  █ █   ██   █  █ █ █ █ ████  █ █     █ █  ███ ██ █████   ██ █  ███   █     █   ██ ███ ███  ██  █   ███       ██    ███     █ █  █ ██ ██ █████ █ ██  █  ███     ██ █ █  █ █ █  █ ███ █
██  █  █ █  █   █   █ ██    █   ████ ██ █ █ █ █   █  ██ █   █ █ █  ██  █ ███ █    █ █ ██ ██ ██ ██       ██ █ ███   █ █ █ █ █ █  █   █ ████ █      █    █   ██████  █  ████   █   █ █     █ █ ████ █  ██  ██████ ██  ██   █████████ █ ██   ██ ██   ██    █ █   █ ██ █ ██  ███  █  █ ██ ██
██   █   ██   █  ███   ████ █ ███    █    █ █  █  █    ███ █  ██ ██ █████ ██ ███ █        █  █  ███ █ ██ ██ █      ███  ██  ███  █ ██         ███  █   █████ ██  ███  █ █    █   ██ ████████ █ █  █ ███  ███  █ ████    ██   ██  █  █   █ ██  ███    █      ███████████ ██████    ███ ██
██ ████  ██ █      ██ ████ █   ██ █   ████ █   █  █        ██     █ █   ██ ██   █   █    ██ █ ███ █ ████ █   ████   ████  █ ██ ██ ██     ██ █   █    ███ ██ ██  █    █ █   ██ █    ██   █ █ █      ███  ██     █ █ ██  █ ██  █ █    ██  █  █       █ ███████  █████ ███  ██ ██  ██ ███ █
█     █  █  ██  █ ██ ██ ███  █  █ █ ████    ██    ███   █   █  ███ ███ █      █    █ █ ██    █ ███ █  ███  █   ███ ██ ███      █       ███  ██    █    █ ██ █ █  █ █  ██ ███  █ █  █   ██   █   ██  ███ ███ ███ ███ █ ██ █          ███    ██   █   █ █     █    █ █  █ █   █   ██  ██ █
█   ██ ██ █ ████ █  █ █████   █   ██ ██       ██    ██  ███   ██ ████  █ █    █   █  █     █           █ █    ██ ███████   █        ██   ███   █ ██ ██ █ ██      ██  █ █   ██  ███ █  ████ █ █   ██ ████  ███        █  ██████  █ ██ ███ █  ██   ███ █   █ █ █  █    █    ████ ██ █  █ █
█  █ ██ █   █ █ █ ██  █ █   ████  █████ █ █ █ ██   ████  █     ███ █   █  ██ ███  █████ █   █  █████ █ ██  ██  ██ ██  █    █    ███   ██ █ ██  █  █ █████ ███ █    █   ██  █ ██ ████  ███ █   ██ █ █  █ ██ ██ █████  █ █   ██ █  █ ████ █  █   █ ██ █      █        █      ███       ███
█      ██ ██  ██ █  █  ██ █ █   █    █  █ ███ █ ██ ██ █  █ █ █  ███ ██ █     ███ █   █  ████   █  █  ██   █   █ ██ ██   █ ██ █ █  ██  ███   █  █   █████████████   ███ █   ██  █   ██ █  █  █████  ██  █  █      █     █ █   █ █  ███ ███  ██ ███████   █ █ █ █ ██ █████ █   █  █    █ █
█ █   ███ █  ██ ███ █  ██     █ █   █ █ █       ███  █ ██       █ █ ██ █████  ██ █   █   █  ████  ██ ████  █    █     █████ █ █   █  █ █       ████ █ █ █    ███  ██ █  ███ ██  █    ██    ██ █ ███  ███  ███   █ █ ██ █   ██ ███ █ ███ ██  ██            █ ██ ██     █ █ █     █  █  ██
█     ██     █  █ █    █ █  ██ █ ████ ███ ██ █ █  █   ██ █    █  █████ █ █  █ ██     █  █ █    █████    █  ██ ████     ██ ██  █ █   ██    ██  ██    █ █ ██  █ █ ███  █  █ ██ █   ██        █  ██     █ █  █ ████ ███ █ ██  █  █  █   █  ██   ████   █ █ █ ███   █   ██  █ █  ██ ██   ███
███  █ █ █   ███ █     █ █ ██ ███  ██ █ ███  █ █  █   █ ██  ███  █ ███ █ ██  █     ███ █    █ ██ █  █ ████  █      ███ █  █ █     ██  ██████ ████████    █ █       ███   ██  █  ██    ██  ███ ██ █ █    █████ █   █ ██  █   ███  ██  █  █  ████  ██ █  █ █  █  ████  █████    ███ ██████
█  ██ █ █ █  ████ █ █  ██ █     █████    █ █ █ █ ██  █ ██    ███   ██ █ █   █  █  █████  █   ██ █  █ █████     █  █  █    █     ██ ███          █ █ █  █ ████   █   █ █ ███  █      ███ █    ███    █  ███████ █ ██ █      █ ████  ██  ███ █    █   █████ ██      █      ██ ██  ██ █   █
███  ██  ██    █   ██ █ █   █  █ ██  ██ █ █ █    ██    █  █    █  █ ██ █ █ █    █   █  █ ██  ███ ██  █ ██  █  █ ███   █  █████ █   █ ██  ██ ██     ██ █ ██ ██  █ ███   █  ██ ███  █████         ██    █ █ ██   █   █ █ ██    █ █     ████ ██ ███  █ ██  ███    █  █    █   █  ██ █    ██
██████   ███  ██           █  ██   █ █ ██ █ ██ ███   ███    █ █ █████   ██  ██ █  █ ██   █████ █ ███    ███  █ ████  █ █     ██   ██       █ █ █ ██ █  ████  ███  █████ █    ██ ██ ██ █ █ ██ ██████ █ █ ████ ████ ██ █   █  █    █ █  ██   █ █    ██ ██  █ ███    █████ █  ██ ██ ███ █ █
█  █  █ █ ███    █ █  ███ █  █████ ██    █  █  █   ██ ███ █ ██   █   ████  ██   █  █  █  █  █ █ █  ██ ██ █ █    █  ██  ██   █  █ █ █ █   ██████    ██████ ██ █    ██ █ █     █ ███     █ █ █   █  █ █ █  █ ██   ███ █        █  ███ ███  █ █ █ █ █ █ █ █   ███  ██    █ ███  █   █ ███ █
█ ██  ██ ██ ██ █ █             █  █        █ ███ █ ██ █   ██████ █     █   ██ ███  █  ██  █  █   ██ █  █    █   █ ██ ███ ██ █ █ █       █    █    ██  █ █  ███   █   █     ██ ██ █   █  █  ██  █  ███  █  ██  ███ ███  ███ ███     █  █     ██  ██ █  ██ ███  ██  █   █  █   █         █
█  █  ██ ████     ██ █     ███ █ ██       █ █ █   █████ ██  █ █       █ ███  ██ █      ███ █ █    █ █ ██  █ █    █  █  █    █  █    █   █   ██   █  █     █  █     █ █   █  ███     █   ██ ██ █ █  █ █   █  ███  ██  ███  █ █ █       ███ █   █ █  ██ ██  █████  █ █  █   █    █ █   ███
█    █ █  █   ██  ██ █ █ ██    █  ██   ███ █    ████ ██  █      █ ██ █ ███████   ██ █    █   █      █   █ ███ █  ███ ███     █   ██  █ █  ██ █  ███ █ █  █  █ █ █     █ █ █ █ █   ███ █ ██  ██    █    ██  █  ███  ██  █  █ █ ██  █   █  █ ███ █ █ █ █  █     ██  ██    ██ █ ██   █    █
█  █  █  █  ██       █ █          █  ███  ██            █   ██ ██  █ █ ████   █ █ █   ██████ ██  ██ ███  █ █ █  ███ █     ████     █     █ █ ███      ██  █ ██ █ ██  ██ █ ███      █ ██ █  █    █ ███ █ █    █  █  █ ██  █  █ █ ███    ██   █ █  █  █ █    █ ██   ██     █ █ █ ██  █   █
█████ █  █ ███ █ ██████ █   █   █ █ █ ███     ████ █    ███ ██  ██ ████  ██   ██        █  ██   ██ █  █ █   █ ██ █  █   █████   █ █ ██    █ ██  ██ █████  █     ██   ████   █   █   ██  █    █ █        █████ █ █  █    █  ███     ███  █ ██ ██ ████      █ █    █ █        ██  █  █  ██
█  ██ █ █    ██ ██  ███  █ █  ████  █ █  █ █ █    ██ █  ██  █ █ █     █ █    █     ██  █ █   █     █    █ ██ █    █ █ ███    █   █   █  ██     █   █ ███ █  ███ █ ██    █ █████ █   ██ █ █   █     █    █ ███  ██  █        ██  █ ██     █  ██ █    █ █  █    █  █ █  █ █ ███████     ██
█       █  ██   █   █ █  ███   █   ███ ██     ██  ██ █   █  ██ ██    █ █ █ █   ██  ███ ███ ███     ██ █ ██  ███  █    █ █  █  ██████ █   ██   █    ████ ███ ██ █ █ █ █     ██ █ █  ███       ██ ██████ █  █   ███  ███  █ █ █   █    █        ███   ██ █   █   ██ █ █ █ █    ███     █ █
█  █ ███     ██ ███  ██    █ ███ █   ██████  █ █ █ ███ █  █ ███ ███ █  ██ █  ██      █  ███   ███ ███  ██ █  ███ █  ██   █    █ █      ██ ████  ██   ██ █     █ █ █ █  █    ██   ████ █ █     █ ███ █ ██   ███   ██     █ █████ ██ ██ ██ ██ █   █ ███ █     ██ ██   █ █  █ █ █ █   ██  █
██  █        █ █  █  ████ █ ██ █ ██ ███ █ █ ██  █ █████  ███      ████  ██ █   █    █ ██      █ ██     █    ██   ██ █ █      █      █  █  █ ██ ██ ██   █████ ███ █ ██ █ █    █ ██████ █ █  █  █ █ █ █ ███     ██ ████ ██  ███  █ ██ ██ █ ██  ███ █  █   █   ██     █  █    ███    █ █  █
████████████████████████████████████████████████████████████████████████████████████████████████████████████████████████████████████████████████████████████████████████████████████████████████████████████████████████████████████████████████████████████████████████████████████████
