████████████████████████████████████████████████████████████████████████████████████████████████████████████████████████████████████████████████████████████████████████████████████████████████████████████████████████████████████████████████████████████████████████████████████████
██  ███ █ █ █ █ ██  █ █  █  █ ███  ██ ███   ████   █ ██ █ █   ██ ██      █  ███ █     ███ █  █   ██     ████    ██████ ██  █    █  ██ ██   ██ █ █  ███  █ ███ █   ████  █ █    ██    █████    █  ████ █  █   ████  █   █    ███ ████  ██ ██  ██ ██   █ █     ███ █ ██ █ █   ██ █ █    ██
█ ███  █████    ██  ██  █ █  █  █ █ ███  █  ██ █████    █  █    █ ██    ██  █   █ █ █  ███ █ ███         ██ █ ███  ████████ █  ███   █ ████  █ ████  █ ██      █  ██ █   ██  █ █ ██ █ █    ██  █  █ █ █ ████         █   █  ███    ██ █  ████ ██ ██ ██  ███  █ █  █  ██  ██    █       █
██  █  ██    █ ███  ███  ██  █ █ █ █ █ █ █   █ █ ████ ███ █ ███ █    █ █  █  █ ██  █   █  █ █  ██ █  █ █   █  █    █  ███ ██  ███ █ █ █ ██ █   █ █ █ █ ██  ████ ██ █   █  ██ █ ██    █   █  █  █   █  ██ █ █   █ ██  █  █ ██ █ █   █ █     █ █  █████  ██   █   █  ██   █ ██    ████   █
█    █    █  █   █    █  ████ █ █     █   █    █   █  ██  █   ███ █ █ █  ██ █ █  █  ███ █      █ █ ██ ███      ██ █  ███  █   ██  ███ ████ ██ █   ████ █ ███ █  ███  █ █  █  █  █    ██  ██ ██     ██  █ █  █ █         ████████  ██ ███    █████    ██ █   ██ ████ █  ██ █      ███   █
█   ██ █  ████  █ ██ █████ █         █ █    █   ███ █  ██ ████          ██ ████ ███  ██ █ ███ ██ ██  ██  █ █  █    █ █████ █ █    ██  ████ █  █ █       ███  ██ ████ ██ ██      ███     █ █    █  ██  ██    ████ ███  ██  █      █ █    █ ███   █  ███   █ ██   █  █ █  ███ █   ████   █
██ █  ███    █  ███    ███   █ █    ██ ██ ██ █   █ ██ ██ █   █ █ █ █ ███ █ █    █       ██  ██   ██  ██  ██     █ █ ███ █ █    █    █ ███ ███  ███ █ ███ █  ████    █   █ ██ █   █ █████   ██  █ █  █   ██    ███ █       █   ██    █    ██    ████ ██     █ █  █      ██  ██ █  ███ ███
█  █  █ █ █ █   █  ████ █  ██  █ █ ███   █  █  ██    ███ ██ █ █ █ █   █ █  █ ████   █     █  █      █     █ ████   █    █  █ ████ █   ███ █ ██  █  ██ █ █ █  █  █  ██  █ █   █    █ ███ ███  █  █  █ █   █ █ ███  ██   █       ██ ███  ██  █  █    ██    █ █  █  █ ██  █    ██ █     ███
█    █████ █   ██   █ █ ██    ██  █████    █  █    █ █ █ █  ██   ███ █ █ ███  ██  ███      ██ █ █ ██    ██   █ █ █ █   █   █     ███ █   █  ████ ███   █   ██  █      ███ █  █   █      ███   █  ███ ██ █ █      ██ █ ██  ████ █  █ █        ██ ███ █   ██ █  ████  ██   █  █ ███  ███ █
██ ██ █ █ ██ ███   █ ████  █     ███  █     █       █     █    █ ██       ██  █ ███    █     █ █  █ ████    █████ █   █  ██  █ █████ ███ ████ █ ██ ██     ██ █████ ██ ████ ██  █        ██  █ █ ███ ███ █ █    ████    █   █ █  █ ███████ █ ██  █  █  █    ██  ███ ██  █ █████  █ ██   █
██  ████ █    █ ██   █  █ ████   ██       █  █  ██     ████   █  █     █ ██   ███    █ █ ████   ████  █    ██  █  █  ██    ██    █  █ █ ███ ███ ██   █  ██   ██ ██ ██ ██ █ ██      ███  ███ ██ █       █  ██ █ ██ █████   ███ █    █   ███ ██  ██ ██ █   █ █    █  █      █   ██   █   █
██  ███ █ █ █  ███   ██ █  █  ██   █ █ ██   ██    ████    █ █  ██   █  █ ███ ██  ██ █ █  ██  █    █ █  █  █  ██ ██   ███    █  █  ██  ██ ██ █      ███ █  █ █ ██ █   ██    █    ████  ███ ██    █  █        █    █ █ █ █████ █ ███  █  █   ██████   ██ ██   ██ █████  ███████ ██ █████ █
███  ██     ██    █    █   █ ███  █ ██  █████ █  █     █ █   ██ █   █   █  █ ██  █   █ ██    █  █  ███ █  █      ███  █  ██ █    █ ██ █  █████ █ ███  ███   ███ ██     █     ██ ███     █   █  ██      █  █  █ █  ████   ████ █ █ █ █ █ ██  ██ ██ █  ██ ██ ████   █ ██    ██ ███   █   █
█    ███    ██  ██   █ █    ██ ██  █  ██        █ ██    █   █    █ ██ █ █ █ █   █          █ ██   ██ ██    ██   █ █  ██ █    █ █   █████  ███ █  █████ █ ██████    █  █  ██   █████  █ ██ █      █  █      ██ █ █     ██     ███  ██ █ █    ████  █  ██ █ ██  ███ ███   █      █ █  █  █
█  ██ █ █    ███ █  ██████  ██     █ █ █  ███  █ ██      ██   ███ ██ █ ██         ████ ███ ████ ██ █ ████ ██      ███   █   █  █  █     █ █    █    █   ██ ██  ███  █    ███ ██  █ █      ███ █    █  ███ ██ █ █  ██ █ ██  ███ █  ███ █    ██        █ ████      ████ █      █ █ █   █ █
█  ██ █   ██   ██   █      ██      ██ █ ███      █ ██  █    ██  ███  █  █ █████ ████ █ ██  █ ██ █   █  █   █ █   █   █ █ █   ██ █ █    █         █████ █ █   █      █  █  █ █ █   ██   █  ██  ███ █   █  ██ █ █   ██   █ ██      █  █   █   ██    ███ ███ █ █ ███ █ ██  █ █ █ █    █   █
█   █    █   ███ █ █ █ ██    ███ █   █  █   █████  ██ █ ██ █    █  █ █  ██ █ █  ███  █   █ █ █ █  █       ██ █  ████ ██ █ ██ █   █     █   ██ █ ██  ██ █ █ █   █ ██ █ █    █     ██   █ █ ██ ██ ██  █ █ █ █ █ █      ███ █ █   █  ████   ██ ███  █████   ██   █   ██ ██   █ ██ █ █ █ ███
███  █ █ ███ █   █  ███ █ █   ██ █ █       ██  ███  █ █  █ █  █   █ █ █████ ███   ██ ██  ██ █  █    ██ █ █    █  █  █ ███  ████    █  ██  █ █  ███     ██ ██ █       █ ██ █████ █ ██ █ █ █ █   █ █    ██ ██  ██ █ █     █ ██       █ █  █ ████ ██ ██  █  █   █ █   █   █     █  ██    ██
███ ██ ██  ██     █ ███   █ ████ █  █  ███ █ █  ██  █  ██  ██ ██    █ ██ █  ██ █████ ██  ██     █ █  █ ██     █  ██████    █  █  ██ ██   █ ██  █     ████  █  █   ██     █  █ ███ ██  █     ██  █    █  █  ███   ███ ███ ██ ███   █ █    █    █  █  ███  ██████  ██  ██  █    ████  ████
█  ██ █ ███  ████ █       █   ██  █ █  █ █  █       █      █ █ ███  █  █ █ ██ ██  █   █ ████████  ██ █ ██ █   █ █ ██ ██       █ █  ██     ██ ██  █  ██ ██ ██  ██ █ █ █    ██  ███  ██   ████ ███ ███  ████     █  █   █   █ █ ███   █  █   █    ██  █ █  █  ███   ███    █ █  █  █ █████
█ ██ ██ ██ █     █ █ █   █████  █ █ ██ █  █  █    ██ █ █      ███ █     █ ██ █   █  █ ██      █ ██   █   ██  ███ █   ██ █ █ ██  █ ████ ██ ██████ █████ █  ████   ██ █  ██      ██    █ ██   ██  █ ████    ███   █ █    █ █  █    █   ███   ████  ███  █ █    ████  █ █ ██  ██ ████  ██ █
██ █ ██ █  ██ █   █ ██   ███ █   █   █  █ █   ██  ██ ██ ██  █  ██ █      █  ██   █ █ █  █   ██    █ ██ ████ ██ █ █   ██████    █ ██   █    █ ████   ███   ██ █ ████ ██ █   █    ████ █ █  ███   ██  █ ███ ██   █ ████    █ █  ██ ███ █   █ ██  ██ ██   █ █ ██   ███   █  ██     ███ ██ █
█  █   ██  ██    ███ █ ██ █  ████ █ ██ █     █ █   ██ █  ██  █ █  ████   ██    ██ █ █ █     ██ █ ██ █  █ █    ██ ██  █  █  ████ ████    ██  █  ██ █    █   ██████ ██             ███  █  ███ █ █ █  █ ███ █   ███████  █  █  █      ██ ██ ███  █████ █    █ █ █    █ ██ █ █ ██ █  █ ██ █
█ ███     ████  ██          █   █ █ █  █ ███   █       ██ ████  ███ ███ █  █ █      ██  ██ █  █  ███   ██     █ █  ██  █ █ █ █ █  ██  █   █  ██    ██ ██    ██  █ █     █ ███  █ ██████   ██ █    ████   ██ ██  █  █ ████ █ ███     █ ██ █    █ ██   █ ████ ████      ██  █  █ █   ███ █
████ █  ██ █ █ █████ █    ███████  █ █ ██   ██     █ ██████  █ ██  ██ ████ █  ███ █          █ ███   █ █ ████ ██  █ █ ██  █ ██ █  ██ █   ██       █ ██ ███  █   █ █   ██ ██ █████     █ █     █        ███    █ █    █ █ ███   █ █ ██  █  █   ███      ███    █ █      █ █ ██ █ █ ████ █
█  █ █      ███      █ ███   ██  █     █ █ █  ████      ███  ███ ████   ███  ██ █ ██   ██ ██  ███    █  █   █ ███  ██████   █  ████ █████     █████ ███ █    ████ ██  ████    █ ██ █ █ ██   █ █  ██ ████ █    █ █  ███ ██  ████  █   █ █   ██ █   █ █   █ █████ ██ █  ██ █████ █ █     █
█ █    ████   █   █ █   ██    ███      █ ███ █     █      ██ ███ █  █ ██ ██   █   █████   █ █  ███      █████ █ █         █ ████   █ █   █ █ ████ █   █  ███  ██ █    ██   █    ███  █   █ █ █ █  █   ███    ██████ █  ██ █  ███       █  █ ██ ███    █     █ █ █  █ █      ██ ██ ██  ██
████      █       █ ███    ███   ██ █   █████ ██  █  ██  ██  █  ██ █  ██ █ █ ███  ███ █   ███  █ █ █ ██████ ████ █  █  █ ██ ██    ███  █     ██   █     █ ███    █   ██    ██     █ █  ██ █ █  ██ █ ██  █          █  ██    █   █ █  ██  █ ███ █  ███  █    ██  ██ █       █ ███ █  █  █
██         █ █ █      ██  ██ ████ ████ █  █      █     ███  █ █    █████      ████    █ ██ ███  █ ██     █   █ ██ █ █   █ ███ ██  █  ██████  █  ██ ████    ███    █  █     ██ █  ██ █   █    █ █ ███ █            ███    ███  ██  ██ █ ███     █   ██     ██ ██ ████████       █   ███ █
█     █ ██ ██ ██ █ ███  █ ███ ████ █    █ █  █    █  ███ █    █ ███ ██ █  ██    █ ██  ██ ██ ██  █   █████ █  █  █████████  ███    ██  █  ███ ██  ██ ██ ██████ █  █  █  ███ ██ ███          █ █  █ ███ ███   █ ████  █  █ █████  ██      █ █  █   ██ ██ ██ █ █ █ ████ █ ██ █   ████  ██ █
█           █ ██    █   ██ █  █ █        █     █ █  █ ██ ██ ███  █     █ █    █   █     ███   ██ █████ ██  █      █ ██████  ███   ██  █ █  ██     █  █  █ ██      █ █     ██    █   ████   █ █   ███     ██  █ █   ██ █     ██ █ ██      ████  ██   █ █ █ █   █        █ █ █ ██ ██   █ █
██   █    ██ █ █ █   ███  █ ██ █   █ ███  █ ███████ █  █   █      ██  ██ █ █ █    ███ █  ███   ██ █   █  █  █ ██  █ █ ██   █ ██ █ █ ██ █  ██    █  ███   ██ █   ██     █        █     ██  ██      ███  █  █ █ █  █        ███      █     █     ██ █  ███   █  █████  █    █  █ ███ ███ █
███   █  ██ █   ██  █    █  ████    ██       █     ██ █   █  █  ███  ██ ██ ████ █  ██ █    █   █ █ █ █ █ █████ █  █  ████   ███ █    ███  █  █   █    ███   █ █        █  █   ██  ██   █ █  █  █ ██        █   ███    ████ ██ █ █   ██ █  █ █ ██ █    █ ██ ██      ██  ██ ██   ██ ███ ██
█   ██  █  ██████      █  █  █ █ ███  ████ █ █ █ █ █ ██    ██ ███   ██       █     ███   █ █  █  ███   █     █ █   █    █  █ ██  ██ ██ ███     ███  ██   █ █   █   █ █ █  ██  █████ ██   █ ██ ████   ████   ██   █████   ██████ █ █ █   █      █  ██   █  ██ █ █  █  ██ █ █    █████ █ █
█████   █  █ ██ █ ████ ██ █  ███    █ ███   ██   █ ██    █ ██  █  █ ██ █  ██ ██  ██  █   █  ██   ██ █ █ █ █ ██ ██ █    █ ███ ██  █ █ █ █   █ █  █   █  ███   █ █ ██ █ ██    ██   █ █     █████ █ █         █    █   █ █ ███ ███  ███    █  █  █   ████ ██    ██ ██    ████████  ███ █  █
██  █  █ ██ ████████         █ ████ █   █   █     █   █   █  █  ████       █ █  ███  ████ █  ██    █ █ █   ████ ███  ███ ██      █ █  █    ██ ██ ███ █ ██  █  █ ██  ███  ████████  █  ██ █████  ██ █ █████       █ █  █ █████ ██   ██ ██ ██   █  █      ███              █  ████  ███  █
█ █ █████  ██ █      █    ██    ██   ██ █ █ ██   ██ █  ██      █     ████  █  █    ████ █ █  █  █ ██     ██  ███   ██   █  ██    █████  ███ ████  █ █ ██ █ █  █   █   ██ ████ ███       ██  ███ █ █   █ █  ██  ███      █    █    █      █      █ █ ████     █ █  ██  █ █ ██   ██ █  ███
██   ██ █ ███ █   █ █ ███ █████ ███  █ █  ███  ██ ███ █  █ ███  █    ███ █  █ ███        █ █    █  ███   █  █ █  █ █  █   █   █   █  ███ █  █   █ ███ ██ █  █ █  ███   ██  ██  ██   █ ███   █ ███ █   █ █ ██    █ █ █ █      █ █       █     █ █      ████ ██ █  █ ██ ██    ██████  ██ █
██   ██  ███   █    █ █  ███   █  █  █ █ ██  ██   █   █ █   █ ████    █          ███   █  ███ █ ███   ███  █  ███  ████ ████ ████ ████ ██ █ ███   █         █ █   █ █   ██ ███ ██   █████  ██ █ █  █   █ ███  ███       ███  ███ █    █ ██    ██     █ █ █  █ ██  █ ██ ██     █████ █ ██
██ █████    █ ██ █  ███    ████ ██  ████ █████    ██    █     █ █ ███   █    █ █                █ ███  █ █ █ ███ █  █   ███ █ ███  ████ █  █ ██ ████ █    █   █  ███    ██ █     ████  █  ██ ██  ███  ██  █ █  █  ██ ████  █    ██  █ ██  █  ██   ██  █            █   █ █    █     ██ █
██  ██ █ ██ ██  █      ███  █  █  █   █   █       █  █  ███     ██   █  █ ██ ██   ██  █     █ █   ██   █ ██ ██  █████ ██ █  █████ █ ██ ███       ███  ███       ███ ██   █     █ █ ██ ██  ██  █ ██  █ █  ██  ██   █ █ ███████  █ █    █  █   ██  █   ███ █     █ █ █    █    █   ██   ██
█        ███  ██ █   █   █ ██ ██ █   █ ██ █ ██████  ██  █        █ ██████     █ ███  ████  █       ███ █       █     █   █  ███████  █████ █ █   ███  ██   ██       ███         ███        ██  ██   ██   █ █ █ █ █    ██    ███████    █  ██    ██   ███  ██ █ ██     █ ██  █ █        █
█ ████     █  ██  █ ██       ██  █    ██ ███  █  ██ █ ████ ██    ██ █  █ █  █ ██  █     █ █ █     ██    █  ███ ██  █ █   ██  █ █    ██ █ ███ █ ██ █████ █   █████ █ ██ █ █  █ ███ █ ██████ ████     ██████     ██  ██      █   ██  █ █ █████   ██    ██     ██   ██   █ █  ███  ████ ███
█     █  ██     ██ █    █          █  █          █ █ ███   █  ██ ██   █████     ███   █ █        █ █  ██      ██ ███ █ █   █ ███  ██         █         ██ ███ █ █ █ ██ ██ █ ██ █  ████████     █ █      █  ████ █    █ █  ███   █   █ ███ ███  ██ █  █  █ ██  ██ █     █  ██████   ███ █
██  ███    █ ██ ███████ █ █ █  █ █   █ ██  ███ ███ █   █  █ ███  █   █  █ ██      ████ ██ ██ ██  ██  ███   ██  ██ █  ██ ██    █  ██ ██  █  ██  █ █      ██  ██   █        ██████    █ ██          ████ █  ██ █ ██    █ █     ███   █ █      ██    ██ █     █ ███   ███    ████     █ █ █
██    █ █      █  ██  ██    █   ██   █  █ █  █    █████    ██   █ █  ██  █ █ ███       ██       █  █ ██  ██  █ ██    ██ ██   █ █   █ █  █  █ ████ █ █ ███ █    ██  █  █ █   ████  ███ ███████  █ ██ ██  ████ ███  ████ ████   █ █   ██      █ ██ █   █ █      ██  ██ ██     ██   ████ ██
█ █ █   ████   █     █ █ ███  █      █      ███ ███    ██  █   █  █    ██ ██   ██   ██ █ ███ █ █   █  ████   █  █ █   █  ████ ███ █  ████ █ █  █ ███  ██ █       █ █  █ ███   ██ █       █ █ █    █ ███     ████      ██   ██   █ ████  ████   █   █   █ ████ ██    ██  █  █ ██ █  █ █ █
██ █  █    ██ █ ██████ █  █ █   ██   ████   █  █  ███   █      ██  ██   █  █   █    █        █   █ ██  ███   ██ █ ██ █ ██      ██ ██       █  █ ███ ██████    ██████ █ █     ██ █   ██     ███  ██ █ ███  █████ █ █ █  █         █  ██   █████        █ █ █     █  █ ██  ██  ██     ████
█        ██████ ██  █ █ █   █   █████     ██    ██ ██ █            ██  █ █   ██ ██            █ ██████       ██ ██   ███ ██  ███ ███   █ ███ ██ ███    ██  ██ ██████  █████ ███ ███ ███    █  █ ███  █   ███  █ ██           ██ █ █    ██ ██ ██ █ ██ ████ █████   █  ███      █  ██ ████
██   ██  █   █████ █      █  █  ██  █ █    █ ██  █   █  █       █   ████ █ █  █ █  ███████████    ███   █    ███  █ █ ██   █████ █ █ ████   █ ███ ██     █ ██ █  ████     █  █  ███ █ ██   ██      █ █ █████ ██ ██ ██ ███    ████     █      █ ██  ██   █ ██  ████    █  █ █  █     █ ██
█ █    ██ ██████  █ █     ██ █   ██ █  ████  █   ██   █   ██  █ ██  ██████ █ █████   ██   ██ █  ██     █  █  █  ██   ██ █  ██    █  ██  █ █ ██  █  █    █ █  █   █ █         █   ██   ██████   █ █   █ █  ████ ██ ████ ████ ███ ██  ██ █   █ █ ██   █ █   █  █ ██ █   █  █     █  ██   █
██ ██████ ██  █     █   █ █         ██ ███     █████ █     █ █ ██   █  █   ██ ██     ███ █ ██ █ █    █  ██ █   ██   ████████   █    █    ████  █  ██   ██  █  █  █  █ ██████     █    █ █  ██ ███ █   ██ ████  █  ███   █ █  ███ ███   ████ █       ██  █ █ ██    ███   ██ █       █  ██
█ █ ████  ████   █ ██  █  ███ ████ ██   █    ████ █   ██  █ ██    █ █   █ █ █    █   █    █   █    ███   █  ██ ███   ██   ██    ██   █  ███████ █████  █  ██ ███   █    ██ █ █  ███ ███    █  █  █ █ █ ██       █ ██  █ █    ██  ██  █ ██ ████    ██  █  █   █ █████ ██   ███ ███ ██   █
█ ████  █ █ █ █  █ ██    █    ██  ██ ██ ██ ██ █ █  █   █ █  ███ █  █  ███ █ █ █  █    █  ██ █ █ █ █ ██████████ █ █ █ █   ██   █████      █ ██ █  ████ █ █ ███ ████ █  █ ██  ██ ██  █  █   █ █ █  ██ ██████   ██ ███   ██   ██ █ ██  █  █ █       ██  ██ █   █     █  ██  █    █ █  ██  █
█  █████ ██   ███ ██  █ ██  ██   █  █      █  █ █ █ █      ██ █ ███ █  ██  █  █  █      ██  ███ █████ █   ██  █   █  █████  █  █    █ █     ███ █  ██  ██  ██ ████    █ █     █   █    ██   ███     ████ ██ █     █   █   ██ ██ █  ██    ██ █████   ██ ████  ██  █  █ █    █    ████   █
██   ██ ███  █ ██             █  ██     █ █  ██ ██   █    ████   ███  █  █ █ █    ██ ██  █         ██ █ ███     ██ ██ █   █ ██████ █  ████ █ ██ █     █ ██ █ █   █ ███ █ █ ██ █  █ ███  █ ████ █ ██    ███   █ ██  ██  ███ █ ██     ██   █ ███████ ██    ██  ██ █     ██    ████ █  █ ██
██  █   █████ ███ ██       █ █   █   █ ██  ██  █    ███      ██ █ █ █        ██   ██ █  ███   █    █ █   █    █ ███   ███ ██ ██  █ ██ █ ███  █    ██  █  ██   █ ██      █  █ ███   ██████████ █ █  █ ███ █ ██   ███   █  █ ██ ██ █      █ ████ ██ ███ █   ███    █  ██   █  █ ██ ██ █ ██
██      ████  █   ██  █ █  █ █ ████ █  █ █  █ █ ██   █ █   █████ ██ ██      █     █ █  ██     ██ █  █ █ ██ █  ██ ███ █ ██  █       ███  █  █ ███    █ █ ██       ██   ██ █  ██    █ █        ██    ██ ██   ██ ██  █   █ █  █ █  █  █        ██  █ █      ████ █ █ ██ ██  ██ █ ███ █ ████
█  ██ █  ██   █ █ ██ █ ██   ██ ██      ███ █   ███ ███  ██  █  █ █ ██ █ ███    ██   ██ █ █ ███   █    █   █       █  █ █ █    ██   █ ██  ████ ██   ██ █   ███  ██     ███████  █  █  ███  █        █  █  █     █  ██ ██  █ █  █  █ █████  ████       ██ █ █   █   ███     █ █████   █ ██
██ █ █ █   ███ ██ ███  █ █  █  █  █████ █ ██ █    ███    █  ██   ██ █ █   █ ██  ██ █  ████    ███   █    ██   █ ███  ██ █  ██   █     █ █  █ ███ █████  ███  █  ██ █  ██  █ ██      █   █  █         ███ █    ██  █  █ ████ ████  ██ ██    █ █    ██   █ █ █    █    ██    █ ██ ██    ██
█  ██ ██   ██ █   ██  █   █ ██ █ █  ██   ██ █ █ █  █    █   █ ███  █ █████       █    █     ██ ████       █ █ ███   ██ █     ██ ██ █  █  █ █████████   █ █   █  █    █ █   █   ██  █ █    ███ ██    █ █  ██  █   █  ██   █     ███  █  █  ██  █   █      ████   █ ████  █ █  ██  ███  ██
█████  ██ ██ ██   █████ █ █       █ ███   █  ███ █  ██ █ ██     █ █  █  ██ ███ █ █      █  █    ██ █ █ ██ ███ ████  █ ███  ██ █  ███  █ ██  █  █ ██      ██   █ █  ██ █ █ ██ █ ██    █ █ █ █ █       ██ █     █ ███   ██  ███    ██ █ ██ ██   ██  █ ███  █   █ ████ ██    ██ ██ ██ ██  █
███   █     █     █  █    ██████     ███ █ ███     █    ███ ██    █  ██   ███  ██  ███ █ █████   █  █████ █ █ █ ██ ██  ██  ██ ██ █  ██  █  ██   ███   ███   ██ █ █    █ ███    █ █ ██   █ █ ██       ██████ ███  ██ ███ █   ██    █    ██ ██    █ █    █  ███ █  ████ █  ███    █ █   ██
█  ███   █ ██ ██ ██ █  █  █  ███████  ██ █ ███  ███  ████ █ ██ ███ █ ██  █ █   ██  █ ██      ███     █ ██     █ █    █   █  ██ █        █  ██  █     █   ██ █  █ █████ ██  █    █   █  █ ███ ████    █     █ ███ ██  █ █ ████ ██   ███ ███   █ █ █    ██ ████ █ █ █ ███ ███  █   █  █ ██
█  █ ██   █  █ ██   ███  █ █ █  ████  ██ █  █  █ █       █ ██ ██ █ █     █ █    ███ █ █     █ ██ █ ██     █ ██  ██     ███   ████ ███ █ █ █ ██  █     ██ █ ██ █     ██  █ █ ████   █ █ ██   ███   █ █  ██  █ █        ███ █████ ██████ █ █  ██  █ █  █   █      █ █  ██  ██ ██ █████  ██
████           █  █ ████   ████ █ █ ██  █ █ █ █ █     █  ███  █  █ █ █ ██  █  █     ███  █  ██ ██ ████  █ █   ██        ███  █ █    █         ██      █  ██  █  ██ █    █ ██ █ █  █  ██  █ █     █ █    █    █  █ ██ █ ██ ███ ██  █ █  ███ ██ █   █ ██ █  █   █ █ ██  █  █   ██████ █  █
███  █  █  █ █   ██ █  █   █   ██   █  ████   ██       ██ ██████ █  ██    █  █ ███████ █      ████ ███ █ ██          █ ██ ██ ███ █    █    ██  █ ██ ██ █     █    █   █  ██    ██     ██ █████ █       █   █       █      ████ █ █  ███ ██  █  ██  █████  █    ██          ██  ██      █
████████████████████████████████████████████████████████████████████████████████████████████████████████████████████████████████████████████████████████████████████████████████████████████████████████████████████████████████████████████████████████████████████████████████████████
