████████████████████████████████████████████████████████████████████████████████████████████████████████████████████████████████████████████████████████████████████████████████████████████████████████████████████████████████████████████████████████████████████████████████████████
███████ █        █ █ ██ ████     ██  █ ██   █ █  ███████ ██ █  █        █ █  █     █ ██    ██  █   █ ██ █ █  ██   █ █      ██ ██ █ █ █ █ █ █   ██ █  █  █    ███████    █      █ █ ███  ███ ██ █  ██ █   █  █   █   █   █  ██ ██  █ ██          █████  █ ███ █ ███  ██  █ █ ████ ██   ██
█  ██   ███      ██ ██   █   ██ ███    █  ██  ███  █ ███ ██████  █ █     █  █    █   ██ █ █ ██  ██████ █    ██ █  █████   ██    ███    ████ ███ ███ █ ██   █  █ █ ████████   █   █ █       ██ ██ ██  ██ ██  ██ █  ██ █  ██  █  █ ██ █ ███      ██ █  █ █  ██    █  ████ ██   █ █ █   █ █
██ █ ██ █     █  ███ ████   █ ██  ███  ██  ██ ███  █           █  ████   █ █████  ██ █   ██ ███       █  ███ ██ ██ █  █  █  █ ██ █   █    ██  █   ███ ██ █  █  █    ████  █    ███ █████  █  █ ████ █ █ █         ███ █ ██ █ █ █   ██   █ █   █       ██    █ ████ ██ █   ████     ███ █
█ ████ ████ █ ███ █ █ ██████     ███   █ █     █   █ █  █ ██   ███ ██ ██  ████████        █      ██ ██ █     █ █  ███ ██ ██  ██ ██        ██ ███   █      █  ██    ████     █ █  █  ██ █ █    █ █  ██ ███ █  ██ ██ █ ███     █ ██    █  █   █   ██████  █ ████ ███  ██ █ ██ █   █    █ █
█      █ ██   ██   █   █ █   █  █     █  ██████  ███ ██ ███ ██ ██     ██    █ █ █  ███ █  █  █ █  █ ██  █    ████      █ █ █ █  █ ███       ██ ██     ██ █  █ █  ██ █ █ ██   █ █      ███  ██ █ █ ██ █    ███    █   █   █ █    ████ █     ██ █   █ █   █  ███ █ ██ ██ █  █    █ ██ █ ██
█  █  █  ████   █  ████   ███ █  ██  █  █ █ █ █ ██ █        █    ██ █ ██  █ █  ██ ███   ████ ████ █ ██ █ ██   █   █  ███ ██  █   ██  █     █████ █   █    █ ███ █       ██   █ █    █      █ █   █      █ ██ ███ █  █  █ ██████  ██ █   █ ████ █       ██  █ ███    ██    █  █  █   ██ █
██ █ █  █  ██ ██   ██  ██ █  █ █████ ██   █        █    █  █   █████   █ ██          ██ █ █ █      █ ██   █ ██   █ █      █  ██   █   ███ █ █  ████   ██ █ ████   ███ █ █   ██   ██ █   ██  █  █ █ ██  ██   ██████ █ ████ ██████████ █ █ █ █   █ ████████     █ █ █  █     █ █    █ ██ █
█ █ ██ ██     ████ █ █████ ███ ████     █ █   ███████ ██  █  ███ ████  █   █  ██   ██ ██  █ ██ █  ██   ██  ██ █ ███ █   █ ██ ██  ██   █   ██  █ █   █  ████ █ █ █   █████ █         █    ██      █  █ ██   █    █   █   ██     █  █       █   █ █ █      ██  █  ██ █   ██   █   █ █ ██ █
████ █               █ █ █ █    █ █ █   █ ██ ███ ██ ██ █ █  █    █ █     █   █ ██ █  █ █ █ █   █ █  █      ██   █ █ ██ █   █    ████    █ ██ █  █    █    ███ █  █  █   █ █ █   ██   ██   ██   █ █ █ ██ █   ███    ██  █   ██ ██ █ ███ ██ ███  ███ ██████ █ ████  ██ ██ █ █   █      █ █
████  █   █ ████  █   ██ ██  ██ █ █  ██ █   ████  █  ████ █  ████   ██  █ █ ██    █  █████ ███ █ █ ██████   █ ██    █ █ ██ █     ███  █    █ █  ███ █ ██   █  ███  █   █  █  ███ █   ██ █      █   █  █████   ██ █ █     █      ██ ██ █ ██ █ ███   ███ █  ███ ███  ██  ███  █  █       █
█     █  ██   ███  █  ██ ████ █  █  █ ██ ██     █  █    ██ █ █ ██ █  ████ █   █     █    ██  █   █ █    █████        █  █    ██  █ █ █ █ ████  ██     █  ██ █ █ ███   █ █ ██  █ █ █   █ ██ ██  ██   ██ █    █ █ ███ █ █ █ █  ██ █  ██ █  █ █          ██    ██  ███    █████    █  █ █ █
██  █   ██ ██ █  █ ███  █  █  █     ██   █    ███   ██  █  ██  █  █  ████    █     █   █████   ███  █ ██   █ ████ █ ██ █ ██ █ ████ ███ ███ ███             ██ ██   █████  ██      █   █ █  █  █     █      ████ █  ████████ █ █ ████████  ██    ███  █ █ █  ██        █ █  █ █  █  █ ███
████  █ ██  █   ██████  █ █     █ █     █      ██ █   ████ █ ███ █       █ █  ██ █    ██   █ ██  █  ███  ██   █ █   ██   █ ██████ █   █  █ ███   █  ██ █   █   ██ █   ██ ██████  █  █  ██   █  ██ ██  █ ████ ███  █ ████ █  █  █  █ ██   █ ██  █  ███  ████   █ █  █      ████  █ ██   █
█ ██    █   ██ █ █   █ █ █      █ ██████  █   █ █  ████ ██   ███ █       ██  █     ██ ██ █    ███  █ █ ██   █ ████  █ ███ █   █ ███ ████   █  ██   █ █   ██  █ █  █  █   █ █      █████  █  █  ██  █ ██ ███  █  ██ ██████ ███  ██  █████   █  ███   ██ ████   █  █  ██  ███     █ █    █
█   █ █  ██  ████     █ █ █ ███████  ██   ██ █ █ █  ██  █ ███  ███       █████  █  █  █ █ █ ████ ██   █ ███  ██ █ █ █   █  ████ █ ████ █  █  █   ██    █     █ ██  █ █ █████      ██      ██    █ █    ████ ██     █   █ █ █ █████ █   █  ███     █ █  █ ███ █  █ █   █   █████ █  █ ███
█ █ ███      █ █ ███ █  █ ██  ██ ██████  ██ ██   ███     █ █  ███████      ██ █      █  ████    █ ███ █████          █  █   █   █    ████ █ ████ ███    █    ██  █ ██       █ ██ █ ███  █ █ █  ███ ██ ██    █ ███  █     █ █ █ █  █  ████  ██   █  ███ ██  ███ ██   █ █ █   █ ██████ ███
█   █   ██   █   █ █ ████ ██      █████ ██  █  ███ █       ████ █      ██ ██ ████     ███   █      ███  █████ ███ █    █  █  █  █  █ █   ███  █ ██ ██  █  ███ █  ██ ██  ██  █ ██ █  █ █ █ ██ █ █ █ ██    █ █ ██      █   ██ █  ███████████     █      ██ ██   ██    █ █  █  █      █ ███
████████  █    ██  █     █  █████  ████████ ███ █  █ █ █   █ ██ █  █  ██  █     █ ██████  █    █ ██   █   █ █   ███ █        ██  █  █ ████ █ █ █    █  █ █ ████    ██ █   ██      █  ██   ███ █ ██    ████ ██ ██      ██ █  █        █  ██ ██ ██  █ ████ █   ██   █ ███  ██ █  █     ███
█████ █  ████     ████  █   █    █  ██  █    ██   ██ ██ █  █████  ████  █ █ █ █  ███ █ █  ██ ██   █  ██ █  ██ █ ██ █      █ ███  ██ █████  ███   █ █      ██   █ █ ██████   █ ██ █ ██ ██████  █     █     █     █    █ █   ████ ██    ███     ███ ███   ██ ██  ████      █   █ █     █ █
█      █ ███  ██   ██  ██   █ █  █   ███ ██ █         ███  ███ █  ██   ████ ███ ██ █  █   █ ██   █  █ █ █ █  ███ █  ██  ██ ███ ███ █  ██      █ ██ ██    █  ██        █   █     █    █        ██ ██ █ █  ███ █  ██     █  █  █ ██    █████   █  ██  █  █   █ █ █        █ ██ ███ █ ██ ██
█  ████████   ███ █  █    █  █████      ██   █ █ █ █    ██   ██      ████    █ █    █ █  █  █       █ ██    █ █ █████ ██     █  █ █ █ ██ █       █ ██ ███  █ █ █      █     █ ██     █ ███  █ █    █ ████     ███     ████ █ █ █████      █ █ █    █ ██  ██  ███ ██    █  █ █ █ █ ██  ██
█  ████       █ █ █     ████ █        █ █    █  ███  █   █ █ █  █  █ █  █  █ █  █████  ██ █ ██ ██   █ █ █ █████   █ ██   █    █ █   █   █  █   ██  █  ██  █    ██ ███  ██       ██   █      █ █ █ █    ██    █  █     ████      ███ █ ███  █████  █      █  █ █    ██ █ █ █ █ ████ ██  █
███  █  ██ █ █ █ ██ █     ████    █  ██         █ █  █ ██    █  ███ █ ██    ██   ██ █   █  █ ██ ██ █ █  █  ██  █  ██ ██ ██   █ █    █ ██ █████  █   ██████ █ █ ██ █  █      █ ██ █ ██   █ █   █████ ███    ██  █      █ ██ █ █       █████  █  ██  █    ██  █ █ ██ █        ██  █ ███  █
███ ██ ███   ██   █   █████  █ █ █        █ █ █ █  ███ █ ███ ███  ████ ██ █ ████  █   ██ ██ █   ███ █  ██  ███   ██  █ █ ██  ████  ██  ███   █ ███ ███   █  █ ██ █  ███ ██ █ ██         █████ █ █         █  ██     █ ███  █  ██ █  █       █     ██ ██  █  ████ █       ██ █    █   █ █
██   █  ██████ █████ █ █     █  ██  ███ ██  █ █ █   █    ██       █    █  █    ███      █   █     █  █ █   ███   ██   █  ███ ██ ██ █  █  █  ██ █  █ █ █████ ████   ███  █  █ █ █ ██ █ █ █ █ █ ██   ███    ███  █ █  ██  █  ███ ██ █ ████ █     ██  ████  █  ███ ██    █ █ ███   █ █  █ █
█ █  ███ █  ████  █ █ █      █   █ █  ██ █    █ █   █   █ ██ ██  █ ██ █    █ █ █  █ █ █  █   ███    ██    █   ███  █    ██ █  █          █     █  █ ██ ███ █ █ █ ██ █  ██ █        █    █      ███ █  ██████  ██   █ █   █ █ █ █   ██ █  ███   █ █   █ █  ██        █ █ █  ██  ███  █  █
██  █   ████ ██  ██ █ █   █      █  ████     █  █  ███  █    ██   ████ █  ███  █    █████   ███ ██    █  ██   ██ ████ █ ████████████  █  █ ████  █   ███  ███   █   █  ██  █ ██    ██ █    █ █  ███ █  █████   ██    █ █ ███    ██  ██   █   █  █   ██ █   █ █ █ █   ███ █   █     █   █
█ █ ██  █  █  █ ███ █ ███ ██  ██ ██  █  █ █  █ █ █████ █     █  █   █ █ █ ████      ██  █ █ █ ██   ███   █     █ ██    █  ██████████   ███ ██   ██ █ █ ████   █████  █  ███    █     █   ██     ████   █     █ █ ████ ██  █   ██     █ ██    █ █ ██ █ █     █       ██   █ ██ █ ██   ███
██     █   ██  █  ███ ██      ████ █   █  █     ████ ██ ██  █  █  █ █ ██  █   ██ █ █     ███     █  █  █    ██ █ █ █   █  ██ █ ██    ██ █  ██  █    █ █ ██ ██ ███ █   █ ████ █ █       █  ██    ████ █ ███ █  ██ █   █ █ ██ █████ █ ████ █  ██ █     █     ██  ██   █ █      █     █ ███
█  ██ ██ █ █ █  ██ ██ ██ █  █ ██ ███    ██  █   ███   █████ █ ██  █    ███ █  ████    █ █ ███ ██  █ ██ ██ █      █      ███   ██ █ ███ █ █   ███ █     █  ██████  █  ██   ██ █       █  ████  ██ █ ██ █  ███  █    █ ██       █ ██   █   █ █    █████ █   █ ██  ██  █████ ███   █ █ █  █
█ █ ████   █  █  ██ ███ █ ████  ██ █   █ █     ██  ██  ██ ███  █ █ █   █  ██     █  ██  █     ██ ███████    ██     ██   █      █ █   ███ █  █████ █ █  ███ █ █   █     ███    ██ ██ ██ ██ █ █ ██    █     █ ███  ████   █    █ █ ████  ████   █ ███ █ ███   ████ █   █ ██ █  ██    ██  █
█   █ ██  ██ █ ██    ██ ██  ██ ██ ████████  ██   █ █ █ ██ ███    ███  █  ██ █   ███ ██ █   █      ██   █ █  ██ █  █  █  ███ ██    █ ████      ██   ███ █ ██ █  ████ █  ███  █  ██  █   ██       ██ █ █ █ █  ██ █  █ ███ █ █ █ █  █    █     ██  █ █     █    █      █  █ ██ █ ███  █ ███
██  █ █  ██  ██ ██      ██   ██   █ █  █  ███ █   ███ █  █  █  █   █    ██ ███ ████ █ █    █  █    █   █   █  ██ ███     █ █  ██ █ █  █  █ █ █ █████     ███   █ ███ █ ██   █ █ ███ ██ █ ██   █  █ █ █ ███  █ █   ██ █   █  ██  ██ █   ██       █ █ ███   █  █  ██ ██████    █    █ █  █
█    ███ █ █ ███ █ ███  █ ████  █ █ █       ██ ██ ██    ████ ██  ███  █ █ █   █████    █ █  █ ██   ██    ████ █ █ ███  ███ █████  ███   █       █ ██ █     █ █   █   ███  ██   █  █  ████    ██ █     ██   ██ ███ █ █   ███   ███        █ █ █████       █ █  ███ █  ███ ███ ███ ██  █ █
████    █ █    █ █  █  █   ███ ███     █  █   ██ █ █ █████  ███████ ██  █ █  ██    ████    █  █ ██   ██      ██    █     █ ███           ██   ██ █      ███ ██ █   ██ ██ ██ ██    █    ██    ██ █ █  █     ██ ████         █ █    █    █  █ █  █  ██ ███████ ███    ███ ██ ███ ██ ██ █ █
█ █  ██ ██ ██ █  ████   ██ ███ █   █ █   ██ ██ ██████  █    ██ ███   █ ██    █      █ █ █████ █     █ ███   ██ ███   █  ██  ██ ███   ██  █      ███ ████ █  ██ █ ███   ███   █████  ██ █   █ ███      █ ██   █ ███     █ ███  █   ███ █   █████ █  ███  ███ ████   █   █ █ █ ███      ██
█ ██ █ █ ██      █  ██    █            █ █ █ █ ███     █  █   █ ██ ███ █   █ █ ██ ███  ██    █     █ ██  ███ █ █  █ ██ ██   ██ ███  ███ █ ████     █ █  █ ██         █ █ █    ███   ███   █ ██ █  ██     ████ █  ████ █     ██  █ ███       ██  █  ███  █████  ██  █       █ ███      ██
█  █  ██     ███           █  ██ ██    █   ██   ███ █ █  ███       █ █  ██ ██ █ █ █ ███ █  █   ██ █  █   ██       █ ██  █   █  ████ ██  █        ██   ████ █  █ █ █████  ███  ██   █   █ █ █  █ █      █ ██     █       █ █   █ ██ █ █    ██ ████ █  █   ███████   ███ █  ██     █ ██ ██
█ █ ████  ██  █  █ ███ █   █     ██    █   █  █  ██  █ █     ███    ███ ███   █     █   █   █   ██   █ █  ██  ████  █████ █ █  █  ██ ██ █ ███ █ ██████    █   █    █   ██████████ █   █ ██  █    ██  ██  ████      ███ ██   ███  █ █  ██  █ █     █    ███  █   █████ █████  █     █   █
██ █ ██      █  █  █   ██  █    █ █ ██  ████   █ █ █ █  ██ █  █ ██   ███ ██ ██ ███   ██ █   █  ██  ███  █ █ ████  █   ██ ██ ██  █ ████  ██  █  █  █   █ █ █   █ ███  ██     ██      ██      █ █  ██ █      ██    █  █ ██ █    █  █ █    █ ██ ██████ ██████ █     ████  ██ █████  ██   ██
█   ███   ██ █  ██ ███ ██  ██ █ █ ██  ██        █    █ ██  █  █ █ █        ██    █  █████ ███ ██ █ █   █ █  ██       ██   █   ████ █     █ ███  █ █      ██ █  ██   ███  ██    ███  █   █    █   █ ██ ██ █    █    ██       ████ █ ██ ███  █████ █ █  ███    █   ██  ██  ██  ██ ██     █
████ ███  █  ████  ███ ███ █ █  █ █ █ █   █ █ █  █       █   ███  █     █  █  ██  ██ █ ██   █       █   █   █ ███ ██   ███ ██    █ ██ ███ █████  █    █ ██████  █ █ █ █  ██ █████ █  █   █      █  █  █  █ ██ ███ █ █   █ ██ █ █  ██  █ █ ██ █   ██ ██  ███ █ ██ █   █   █ █ █  █  ██ ██
███    ██   █ █ █   ██ █   ██ █    ██   █ █    ██     █ █  █   █ ██  █  █  █ █  ████  ███ █ █   █     ███   █ █  ██████ █  █ █   █    █  █ ██      █ ███  ███ ████ █ ██   ████ ██ █ █        █ █    █  █   ██ █ █   █ █  ███   ██  ██ ███ ███     ██████ ███████ █ █ █    ██ ██   ████ █
██ █   ██  ██  ██  █  ██    ███ █ █      █        █  █  █ █ █  █  ███ ██   █  ██  ███ █  ██ ██  █   ██ █   ████ █  ██  █  █ █ █ █████   ███  ██ █  █   █  █  █████   █      ██  █ █  ████ █        ████  █     █  ██        ██    ███   ██ ██ █   ██  ██   ███  █  ██ █   █ ██ █      ██
██  █  ██ █ █   █ █ ██ ██    █ █    ██    █  ██  █   █  ███ █████    █ ██  ███    █     ██   █ ██ ████  ██  ██ █ █ █ ██   ██ █ █   █ ██  █    █  █ █  ██ █   ██ ███   █ ███  █   █       █           █        █ █ ██    █ █ █    █         ██ ████ █     █ █  ███ █ ██  ██  █ ████   ███
█  █ ██   ██     ██████  ██ █  ███████  ██ █ ██ █  █ █ █  ██ ██   █ ██████    █  █   █  █    █ █ █ ██ ██   ███ █ ██ █   ████ ████ ██ ███   ██ █ █ █   █   █ ████  ██ █    █    █  █ █  █     █    ███  ███ ██         ██████ ███ ██ █ █      ███   █ ██ █  █   █ █ ███ █    █ █ █  ███ █
█  ███  █  ███    █      █         █  ██ █    ██   ██ █ █  ██   █     ██  █ █  ██████   ██  █████████    █  ██      ███    █  ██   ██   █  █   █████  █ ██  █   █   █   █ ███   ████  █ █   ██   ███  █  █  ██    █  █   █       ██ █ ██  █ ██   █   ███   █████ ██   █  ██ ██ █  █  █ █
███ ███ █    █ ██ █   █     ██    █    █  ██      ██ ██   █ ██ ████    █ █ ██        ███   █  █ █ ████ ███  ██   █  █ ██    █    █  ████  █   █   █   █  █       █   █   █ █  █  █   █   █   █  █  █ █  ██ █  █ ██ ██    ████████   █  █ █ ███  █ █  █     ████   ██  █████  █ ██  ███ █
██ █  ███ █ ███ █ ██  █ ████ █     █ ██    ███ ███           ██ █    █  █  █ ██     ████  ██ ███  ████████ ██       ███ ████ ██████ █  █ █ ██ ██   █ █ ██  ████ █   █ █   █ ███  █ █  ██ ██████ █  ██  ███    █   █   ██ ██   ██  █  █ █        ██ █   ███ █ ███     █    █    █ ██   ██
█ █  ███ █  ███ █  █  ██      █  █ ██   █ ██ █ ██   ██ ██  █ █  ██ ██    ██  █ █ ██  █   █ █  █ █  ██ ██ █   ████   █  █  █ ██████    ██ ████████ █ ██    ██   ██ █ █  █    ██ █ ██  ██ █  █  ██ █ █████    █    ██ █   █     ██████ ███ ██ █ █ █ ██ █████  █  ██████  █████  ███ █    █
█ █   █  █ █████    ██████   █ █ ███ █ █   ███ █  █ █  ██ █    ████  █ █ █  ██████ ██      █        ██  ███ █  ███   █████     ████   █ ██████ █  █     ████ █ ██ █  ███     ██   █      ███  ██      █  █   █  █    ████ █ █        █  █  ██   █  ██     ████ █   █ █        █ ██ █████
███   ██  █ ██ █    █ █  █ ███ █ ██    ██ █ ██   █       █      █ ██      █  █  █  █  █ ███     █   █  ███ ██  █ ███       █   █ █  ██  █ █ █           ████  █ █  █      ███ █ ██ █  █ ██ █  ██   █     ██ █ █ █ ██ ███ ██   █  ██  █   █    █ █    █   ███     █   █     █ █  ████   █
███      █ █ ██ ███ █ █ █      ██   █  ██████     ██████  ████   ███ ███ █ █ ██    █  █ ██  ███  ██  ██ █  █  ███ █████   █       ███ █       █ █ █ ██   █ ██   ██ ██    ██   █████ █    ██  ██ █   ██  █  █ █        █  ████  ███      ██  █   █   ██   █ █ █  ████  █   █   ██ ███   █
██████    █  █████     █      ██  █   █   ██ ██  █ ████ █  ███  ██    ████  █ █ █   ██ █ █ ██  █  █   █ █  █ █   ██    █ ██   █    █ █ ██ ███  █  ██ ███  ██         █████ █  █  █  █ ████████  ██       █    ██ █ █   ███ ██   █ ██     █ █ ██   ██   ██     ██████  █     █   █  █  ██
█   █  █  █   █  ██  █ █  ███ █ ██  █ █ ██ █ ████   ██ █ █  █ ███ █   █████  ██  █ █████ █ ████   █  █ ██        ██   █    ███  █ ████ ██   ██ ██  █ █  █  ██ █  ██  █ █ ███  ██ ██      █  █ ██  █     ██ ████ █ ████ █  █ ██ █  █ █ █ ██  █ █ █ █ ██   █ ██ ███ █   █ █ █   █   █ ████
██   █    █ █  █  █  ██   █    █    █ █   █ █  ███ ██       ███  ███  █ ██        ██  █ █   █████ ████  █  █    ██  ███   █   █    ██ ██     █ ██████ ██   █  ███ █ █       ███   █ ██   █████ ██      █       █ █ █    █  ██    ██████  ████   ██      █  ████         █     █ █ ██████
█ █ █████    █ █  ██  ██ █   █████████  █  ███   █ ███ █ █  ██   ██ █ █ ██    █ █   █  █  ██  █████   █   ██ █   █ █ ████   ████ █  █  ██ █  █ █  █ ██   █     █    █   █   █        █ ███ ███ █   █       ██ ████    █    ███   █  █    █  ██     █  ██████     █ █  ██  ███   ██  █  █
█   ██ █ ██ █ ██  █ █ █ ███  ██████ ██ █  ██    ███ █  ██ █ █ █ █    ███ ███████ ████      █ █     █ █  ██ █ █ █ █ ███  █  ██ ██ █   ██   █  █   ██ █ █          ██  █ ██ █  █████ █ █ █ █ ██  █   ███ ██ ██     ██  ██       ██    ██  ██ █     █  ███ █   █  █   █ █ ██            █ █
██    ████  █ █ ██ ██  ██   █  ██    ███    █ █ ██   ██  █      ███ ████ █ █      ██  █   ██   ██ █  █  █ ██ ██  █     ██   ██ █  ██  █    █ █ ██    █  █ █    █    █   █   █ █ █  █ ██  ██   █  █ █    ███ █  █ ██ ███   █   ███    █ █   ████   ████ ██     █  █  ███ █  ██ ██ █ █   █
█ ██    ██ █ ██   ██ █     █  ████     █ █ ██  █ █      ██ █ ██  ███ ████ █  █  █ █   ██    ██ █ ███ █  █  █   █   █  ███  ██ █ █ ███  █  █  █   ██       █    █    ██   █     ██   █ ███    ██ █ ████████    █ █  ██  ██  █ ██ ███    █  ██   ████      █    █  ███ █   █  █ ████ █ █ █
█  █    ██      ██ ███  ██  █ █  █ █    ██ █████  █  █ █   ██  ███    ███   █   ██ ██   ██████  ██ █ █  █   ██ ██   ███    ███    ██ █  ██  █████   █ █ ████     █  █ ███ █ █ █      █  ██ ██ █ ███  █  █    ██  ██   █ █ ██ █  ██  ██ █   ███ █ █  ██  █ █ ███ █       █████ ██    ████
███ ██ █ ████ █ ███ █ ██          ██  █████  ███    ██ █ ████ ███        █ █   ██ ██    █    █    █ █ ██       ██  █ ██ █ ██  █ ██ ███    █ █ █  █    ██ █ █  █ █ ██ █ ██     ███  ███   ██ █  █ █   █  ██   ████ █  ██  ███  █       █  █ ██    ███ ██████ ██ ██ ██████   █ █  ██     █
█ ██    ██   █    █ █  ████ ███    ████   █ █  █   ██ █ █        █        █   █ █ █ ███  ██████ ██████  █ ███ █   ██ ██  █     █  █  ██  █ █  █   █   █ ██   █        █ ██   █   ██    ██████  ████ █  █ ███  ██ █  ██  █  ███ ███ █ ██ ██ █      ██      █  ███  █   ██ ███  █  █████ █
█  ███████ ██  ██ ██ ████  ██ █     ███   ██      █ ██     █       ██    █ █ █  █ █ █   █    ██  ███    █   █ ████    ███ ██ ██ █ ██   █████  █     ██   █ ██ █ █ ███  █ █ ██    █  █  ██        █ █    ██ ████    ██  █    ██     ██     █   █ █ █ ██  █  ██   ███      ██  █  ██████ █
████ ██ █ ██████   █   ███   █  █  ██   ██ █   █ █ ██   █ ██ █  █ ██   ███  █  █    ███   █ ██     █   ████     █  ███ ██    ██ ████ █     █   █   █     ████████  █ ███   █ ██ ███ █ ██  █ ███ ███    █ █   █    █ ██ ███ ███ ███    █   ██   ████ █  █            ██ ████  █ █████   █
█ █  ██        █ ██ █ █  ███  ██ █ █  ██  ██ ██ █ ██████ █  █ █       █ █     █    █   ████  █    ████    ██████ ██ █    █  ███ █ ███  █  ██ ██ █  █     █ ██     █  █  ██ ███ ██ █████ █ ██   █ ███ ████ █   ███      █  █   ██  █       ███ █    ████████ ██  ██  ███   ██████ ██ █  █
████████████████████████████████████████████████████████████████████████████████████████████████████████████████████████████████████████████████████████████████████████████████████████████████████████████████████████████████████████████████████████████████████████████████████████
