████████████████████████████████████████████████████████████████████████████████████████████████████████████████████████████████████████████████████████████████████████████████████████████████████████████████████████████████████████████████████████████████████████████████████████
██████████████  ███████████████████████████████████████████████████████████    ██████████████████████████████████████████████████████████████████████████████████████████████████  ████████████████████████████        ██████████████████████████████████████    ███████████████████████
██         ██         ████████████████   ██████   ███████████████    █████      █████████████  ███████████████████████████    ████  ████████ █████    ████████████████████   ███    ██   ████████   ███████             ███████████    ██████████████  █████      ███████   ██████   ███
█                      ███████  ████      █████     ████████████       ██       ███             ██  ████████████████████       ██       ███   ███      ████  ███████████                  ██████                         ██  █████      █████████████   ███        █████     ████     ██
█                     █████████████       █████       ██████████                ██                   █████████████████                   ███████              █████████                   █████                              ████         ███    ████               ████     ████     ██
██                ████████████████         ████       ██████████                ██                   █████████ ██████                    ███████              █████████                   █████                              ███                  ████              ████    █████     ██
███              █████████    ███           ██        ███████████               ██                    ███████   ████                    ████████               ████████          ██        █████ ██                          ███                   ████             ███     █████    ███
████             ████████                           ████████  ████              ███                     █████   ████                   ██████████               ██████          ███        ████████      ██                   ██                    ██             ████     ████     ███
█████            ████                              ████████     █              █████                     ███    ████                   ██████████                ███            ██         ████████      ██                   ███     ███                          ████      ██     ████
█████             ██                      ██       ███████           █         ██████████                ██     █████                   ██    ███               ████                       ████████              ███          ███     ████                          ████            ████
████       ███     ██                    ████       █████           ██████     ███████████              ███     █████                          ██              █████                        ███████              ████        █████    █████                          ███            ████
███       ████     ███                ███████         ███            █████      ███████████             ███    ███████             ██          ███  ██         ██████                         ██████              ██████  ████████   ██████                                         ████
███       ████     █████             ████████          ██               ██         █████████                   ████████           ███           ███████        ███████      ███                █████               ███████████████   █████                                          ████
███       ███       ██████           ███████                   ██                    ███████    ██                   ██           ██             ██████         ██████     █████               █████               ██████████        ████                                            ███
███      ███        ██████████        █████              ██   ████            ████    ██████   ████                   ██         ███               █████                   █████               ████               █████████         █████                                            ███
███      ███        ███████████         ███      ██      █████████           ██████   ██████   ████                   ████████  ████               ███████                 ████               █████              ████████          █████                               ███           ███
██      ███          ███  █████                 ████     █████████            ██████████████   ████                   █████████████             ██████████                ████              ██████              ███               ██████                              █████          ███
██      ███                █████            ████████     ████████              █████████████    ███          ████      ████████████            ███████████                 ██             ████████      ██     ███               ███████                   ██         ██████         ███
██      ████              ██████            █████████    █████████              ███████████     ███         ██████         ███████             ██████████      ███                ████   █████████      ███     █          ████████████           ███     █████        ████████      ███
██      ████             ███████                  ███     █████████              █████████      ███         █████████      ██  ██             █████  ████     █████               █████ ██████████      ████              ████████████           ████     █████        ████████       ██
██       ██             ███████                    ██         ██████             █████████     ███          ██████████    ██        ████  ████████    ███    ██████               █████████████████      ███              █████████              ███     ██████        ████████       ██
███              ███    █████        ████                      █████              ████████    ███     ██    █████  ████  ███        █████████████     ████  ██████                 ████████████████       █               ████                          ██████        ████████        ██
███              ████    ███       ███████                    █████      ██        ████████  ███     ████   ████    ███████          ████████████     ████████                      ███████    ████                       ███       ██                 ██████         ███             ██
███              ████             ████████       ██        ████████     ███         ████████████     █████   ██     ███████           ████████████   ███████                        ██████      ██                                 ██████              ██████                         ██
███              ███              █████████      ███       ███████      ███          ████████████   ██████          ██████             ████████████████████                          ████                                         ████████              █████    ██                   ██
███              ███              █████████       ███      ███████      ███                ████████████████         ██████              ███    █████████                                                                          █████████              █████  ████                  ██
██              ███                ███████        ███       ███████     ███     ███         ████████████████        ██████                      ██████         ██                                                                ███████████             ███████████     █████        ██
██              ███                 ████         ████          █████           █████        ████████████████        ███████                     █████         ████             ██          ██                                    ██████████████          ██████████     ██████        ██
███             ████        ██                   ███           ██████          █████         █████████   ██         ███████                    ████           ██████  ██      ████      ██████               ██                  ███████████████        ███████        ███████        ██
█████          █████       ████                   █            ███████          ████  ███    ███████               ███████                     ███             ██████████     ███      ███████              ███     ███           ███  █████████        ████          ███████        ███
██████         █████       ████                               █████████         ███   ███     ███               ████████                  ██  ████               ████████             ███████              ███      ███                 ███████         ███           ███████      █████
███████         ████      █████  █                           ███████████        ███    █                       ████████                 ██████████                ██████             ████            ██     █       ████                ██████           ██           ███████     ██████
████████                  █████████                          ████████████        █                          ██████████                 ███████████                                   ███            ████            ██████              █████            ███           █████████████████
█████████                █████████                           ██████████████                        ████    ██████████                  ██████████     ██                            ████            ████             ██████       ██    ████             ███            ████████████████
█████████                ████████              ██       ███   █████  ███████                      ██████  ███                           █████         ██                            ████           █████              ██████                              █       ███   ████████████████
████████                ████████              ████     █████   ███    ██████               ██     ██████████                            ████         ██                ██           ████          ██████    ███        █████                                     ███████████████████████
███████      █         ████████       ██      ████     █████    ██      ████               ███   ███   █████                            ████       ███           ██  █████           ██          ███████    ███                                                  ███████████████████████
███████     ██     ████████████      ████    █████     ████     ██       ████              ██   ███      ██                 ██          █████     ████          ██████████                       ███████     █                                 ███                ██    ████████████████
████         █     ███████  ████     ████    ██████   ███      ███       ███████                ███                         ███    ██    █████    ███           █████████                         ██████            ██                        █████                     ███████████   ██
███                 █████    ███      ██    ████████████       ███        ███████                ██                           ████████     ████  ███      ██    ████  ██                          █████            ███████                    █████                     ███████████    █
███                  ████    ███           █████████████       ███         ████████              ██                            ██████        ██████      ████   ███         █                      ███             ████████                    █████                   ██████          █
███                   ████  ████          █████████████                     ████████       ██    ██                            █████          █████     █████    ███                                                ███████                      ████                 ██████           █
███                    ████████           ████  ██████                      █████████     ████  ███                             ███           ████      ████      ███                                               ██████                        ███                 ██████           █
██                  █  ███████             ██   █████                       ███████████  █████  ███                     █                     ████     ███        ███                                                ████                                              ████           ██
██                 █████████                   ██████                        ████████████████   ████                    █                    ██████     █          █                                                                                   █████           ███            ██
██           ████ █████████                   ███████                           ████████████    ████        ███                              ██████                                    ██                     ██                                      ███████          ███           ███
██           █████████████                   ████████                             ██   ████     ████   ██  ████                              ██████                                    ████                  ████          ██           ███          █████████         ███          ████
██           ███████  ███                   █████  █                                    ██       ██   █████████                               ████                                     █████                 ████         ████         ████       ████████████         ████  ███    ████
██     ██     █████                         █████                       █                             ██████████                 ██            ██                                       █████                █████        █████       ████    ████████████████         ████  ████   ████
███  ████                                   █████           ██████     ███            ██              ██████████               █████                                 ████                ████                 ████        █████       ███    █████████████████         ███   ████   ████
█████████                                    █████         ████████     █            ████             ███████████       █     ███████                               ██████                ██           ███     ██          ███       ███    ████████  ███████         ███    ████   ████
█████████                              ████   ████        █████████                 ██████             ██████████      ██    ████████                                █████                             ████                ██       ████    ███████    ████          ████     ███   ████
█████  ███                            ██████   ███       ██████████                 ██████    ███       █████████       █    ████████                                 ████    ██                        ███         ██     ██    ███████    ████        ██           ████      ██    ███
████    ███       ██                  ██████             █████████                   █████    ███         ██████             ████████                                 ███    ████                                  ████   ███   ████████    ███                      ███       ██     ██
███     ███      ████                 ██████             █████████                    ████    ███         ██████            █████████                                 ███    ████                                  ███    ██    ████████    ███                                ██     ██
██      ████     ██████                ████              ████████                     ████    ███         █████             █████████                                 ███     ██                                          ██     ████████  ████                                ██      █
██     █████     ███████                                 ███████                      ████    ███        █████             ██████████                                 ████                                                ███      ███████████        █                        ███     █
██    ██████      ██████                                 ██████               █████   █████  █████       ██████             █████████                  ████            ████       ███                                      █           █████          ██     ██     ███       █████    █
██   ███████      ██████    ██                 ██        ██████              ██████████████  █████  ███   ██████             ████████                 ██████           █████     ████                                                   ███            ███  ████   █████    ████████  ██
██   ██████        ██████  █████              ████          ████             ██████████████   ███   ████   ██████             ███████                 ██████           █████    ████                    ██     ██                                       ████████████████   █████████████
██   █████         ██████████████              ████          ██████           ████████████           ████   ██████     ██      ███████               ███████           ██████  ████        ████        ████   █████                                     █████   ███████     ███  ███████
█     ███             ███████████               ████         ███████            ██████████            ████   ██████   ████        ████               ██████             ██████████        ██████       █████ ████████                                  █████     ████             ██████
█                      ███████████   █          ████         ███████             ████████              ████  ██████   ████                                               █████████        █████████     ██████████████                                ██████     ███               █████
█                      ████████████████         ████         ████████             ██                   ████  █████     ██                                                 █████████       ███████████    █████    ███████                             ██████     ███               █████
██      ██             ████████████████       ███████       ████████████                              █████  ████                                                         ██████████     ███████████████           ████████                            ██████   █████ ██           █████
████   ████            █████████████████     █████████     ██████████████                      █████████████████            ██                   ███████   ██             ███████████████████████████████         ██████████       ██           ███    ██████████████████  █████████████
████████████████████  █████████████████████████████████   ██████████████████   ██████████████████████████████████ ███     ████████████████████████████████████     ████████████████████████████████████████    █████████████████████████████████████   █████████████████████████████████
████████████████████████████████████████████████████████████████████████████████████████████████████████████████████████████████████████████████████████████████████████████████████████████████████████████████████████████████████████████████████████████████████████████████████████
