██████████████████████████████████████████████████████████████████████████████████████████████████████████████████████████████████████████████████████
█████████████████████████████  ████████████████████████  ██████████████    █████████████████████████████████████████████████  ████████████████████████
███        █████████████████    ██    ███████████████     █████████            ██        ██████████████████████████████████   ██████████████   ███████
██          ████████████████           █████████████      ████████                         ███████  ████   █████████████████  ████████             ███
██           ███████████████           ████████████        ███████                          █████    ███    ████████████████████████                ██
██           █████  ███████             ██████████           ██████                         █████    ███     ██████  ██████████████                 ██
█           █████                       █████████            ██████                          ███                      █████████████     ███        ███
█          █████                         ███████             █████                                                     ████████████    █████       ███
█         ██████             ██          ██████              ████                                                            █████     ██████      ███
██        █████            █████         █████              ████                                                              ███      ██████       ██
█████     ████           ████████         ███              ████                                                                        ██████       ██
██████     ██           ██████████                        █████                                                                       ███████       ██
███████                 ██████████                        ████                                    ██                                  ███████       ██
███████                 ██  ██████                         ██                                    ████                                 ███████       ██
███████                      ████                                                                █████                       █       ████████      ███
████████     █                ██                                                                ██████                      ███     █████████      ███
███████████████                                                        ██                      ██████                       ████    ████████       ███
███████████████                                                       ████                     █████                        ████     ██            ███
████████████████                      ██                             █████        ██            ███                          ██                ██   ██
████████████████                     ████                     ██    ██████       ████    ██                                                   ████  ██
███████████████                   ███████          █         ████   ██████       ██████████                                                  █████  ██
████████                         ████████         ███        █████  █████        █████████                                                   █████  ██
███████                          ███████    ██   ███          ████   ███          ██████                                                      ███   ██
███████                          ███       ████████           ████                █████          ███                                               ███
██████                                    █████████           ███                █████      ██  █████                     ██           █           ███
█████                                    █████████      ██    ███         ██   ██████      ██████████       ██           ████         ███           ██
████                                   ███████         ████    █         █████████         █████████       ████          ████         ███            █
███                                   ██████           ████              ████████          █████           ████           ██           █             █
███                                   █████            ███                ██████           ████           ████                                       █
██                                     ███             ███                 █████            ███          ████                                        █
██                 ██                                  ████                 █████            ██          ████                                       ██
██               █████                                 ████                  █████           ██          ████                                       ██
██              ███████                                ████                   ████           ███  ██      ██                                        ██
██      ███    ███████████                             ████                    ██           █████████     ██                                        ██
█      ████     ██   ██████                             ██                                ██████████      ███                        ███            ██
█     ████            ██████              ██████                                        ███████████      ███████                    █████            █
█     ███              █████             ████████                                      ██████   ██      ████████                     █████           █
██                     █████             ███████                                      ██████           █████                          ████           █
██                      ███             █████                                         ██████          █████                 ██        ████          ██
██                                    ██████        ████                         ██   ██████         █████                 ████        ██          ███
██     ██                          █████████       █████████   ███              ████  ███████       ██████                █████                    ███
██    ████                        █████████       ████████████████████          ████  ██████████   ████████              ███████            ██     ███
███  ██████       █              █████████       ██████████████████████          ██   ███████████  ████████             █████████          ████    ███
███████████      ███             ████████      ████████████████████████               ████████████████████             ███████████         ████     ██
██████████        █               ██  ██      █████████████████████████               ███████████████████            █████████████         ████     ██
███████                                       ███████     ████████████                 ██████████████████            █████████████         █████    ██
██████                                         █████       ███████                      █████████████████             ████  ██████        ███████   ██
██████                                         █████        ██                           █████  ████████               ██    █████      ██████████   █
█████                 ██                       █████                                       ██    ███████                      ███      ███████████   █
███                  ████                      ██████                                              █████                      ███      ████████████ ██
██                   ████                      ███████                ███                            ██                       ████      ██   █████████
██                   █████       ██            ████████              █████     █                                              ██████           ███████
█                    █████████  ████           ████████           █████████   ███                                            ████████           ██████
█                    ███████████████           ███████           ███████████████               ███                   ██      ████████           ██████
█                     █████████████             ██████      ████████████████████              █████                 ███      ███████            ██████
██                    ██████  █████              ████     ██████████████████████   ██         ██████          █████████      ███████            ██████
██                     ████    █████       ██     ███    ██████  ████████████████ ████         █████         █████████       ███████             █████
███                    ████     ██████    ████           █████      ████   ███████ ███          █████       █████████         ██████              ████
███                    ████     ███████   ████           █████              █████   ███  ██      ████      ██████      ██      █████               ███
███                     ██      ████████   ███           ████                 ██     ███████     ████     █████       ████      █████  ██          ███
███                             ████████   ███            ██                          ██████      ██      ████        ████      ██████████        ████
███                              ██████    ██                                          ████               ███         ████      ██████████       █████
███              ██                        ██                                           ██                ███          ██       █████████       ██████
███        █    ████                       ██                                                             ███                    ███████       ███████
████       █    ████                       ██       ██                                                    ███                      ████         █  ███
█████            ██                 ██    ████  ███████                                                  ████                       ██              ██
██████                             ████  ██████████████                                     ██           ████                                       ██
███████                            ███████████████████                                     ████          █████                                      ██
███████                             ████████████████                                     ███████          ██████                                    ██
██████                              ███████   ███                                       █████████          ██████                                   ██
██████                              ████                                                █████████          ██████                                  ███
███████                             ███                                                 ████████           █████                                  ████
███████                                          █                                      ████████       ███████                                    ████
████████                                        ███                                     ████████       ██████                                      ███
████████                                       ████                                     ███████        █████      █████                             ██
████████                                       ████                                     ███████                  ██████                             ██
███████                                         ██                                       ██████            ██    ██████                            ███
█████                                                                                    █████            ████   █████                            ████
███                                                                                      █████            █████  ████                            █████
██                                                                                      ██████             ████   ███                            █████
██                        ███                        ███                                ██████              ██    ███        ███                 █████
██              ████     █████               ████   █████                      ██        ██████                   ███        ████                 ████
█              ██████    █████              █████████████                     ███████     █████                   ███        ████                  ███
█             ███████     ████             █████████████                      ████████    █████           █        █         ████                   ██
██         █████████       ████    █      ██████████████                       ███████   █████           ███                 ████                   ██
██        ███████          ██████████    ██████████████                        ███████   ████                                ████              ██  ███
██        ██████           ██████████    █████████████                         ██████    ███                                ██████        ████████████
██         █████            ████████     █████████████                         ████     ███   ███                           ███████       ████████████
███         ████              █████       █████████████                         ██     ███   █████                         █████████       ███████████
████         ██                ████        ███ ███████████       █                    ████   █████                       ██████  ████       ██████████
█████   ██                      ██         ██   ████████████    ███                   ████  █████                       ██████    ████      █████  ███
██████ ████                                 ██ ███████   █████████                     ██   ████                        █████     ███████  █████    ██
███████████                                 █████████     ██████                            ████                         ████     ██████████████    ██
███████████                                  ████████     █████                             █████              ██         ██      █████████████     ██
████████████ ███                       ██     ██████       ████          ██      ████       ███████           ████                 ███████████      ██
█████████████████                              █████       █████        ████    ███████     ████████          █████                ███████████      ██
██████████████████                             ████       ██████       ██████  █████████     ███████           █████               ███████████      ██
██████████████████                            █████      ███████       █████████████████       █████            ███                 ███   █████    ███
██████████████████                           █████       ███████        ████████████████        ███                                        ████    ███
███   ███████████                           ██████        ██████          █████████  ███                                                   █████   ███
██    ██████████                           ███████          █████          ████       ██                                                    ████   ███
█      ████████                          ███  ███            █████                    ███                                                    ██    ███
█      ██   ███                         ███                  █████   ████              ██                                        ██               ████
██           ██        ██               ███                 ██████   █████              ██                                      ████             █████
██           ██       █████            █████  ██            █████    █████              ███                                     ████            ██████
██          ███       ██████        █████████████        ██  ████    ████                ███                           █       ████            ███████
██         █████      ███████      ███████████████      ████  ██    ████                  ██                                  █████            ███████
███        ██████     ███████      ███████████████      ████         ██                   ███                    ██          ██████            ███████
████        ██████     ██████      ███████████████       ███                              ███████               ████         ██████            ███████
████          ████       ████       ██████████████        ██                               ███████              ████         █████   ██        ███████
████           ██         ██           ███████████         ██                              ████████              ██           █     █████     ████████
███                                     ███  █████         ████                            ████████                                 ██████████████████
███       ██                                  ███          █████          ██               ███████                                   █████████████████
███      ████                   ██                        ██████         ████              ██████                                        ████████  ███
██       ████                  █████                     ███████         ████               █████                                         ██████    ██
██       ████                  ██████      ██            ███████          ██                █████                                          █████    ██
██        ██                   ██████     ████            ██████                           ███████                             ███         ██████   ██
██                             ██████    █████              ███                           ████████                           ██████        ███████  ██
███                           ██████    ██████                                           ████████                           ███████        ███████  ██
███████          ███         ████       █████                                            ████████              ██          ████████         █████  ███
████████         ████       ████         ██                                              ████████             ████         █████████               ███
████████         ████      █████                                                         ███████              ████         ██████████              ███
████████           █       ██████                                                         █                    ██           █████████              ███
███████                     █████                ██████                                                                      ███████                ██
██████                       ███              ██████████              ██                                   ██        ██      ████                   ██
██████                                       ████████████            ████   ███                           ████      ████     ███                    ██
███████         ██                           █████████████           ████████████                        ██████     ████    ███                    ███
█████████      ████       ███                 ██████  ████           ███████████████                ████████████    ████   ████                    ███
█████████     ██████     █████                █████    ██            █████████████████████████  ████████████████     ██   █████            ██      ███
█████████     ██████    ██████                 ███                  █████████████  ████████████████████████████           ████            ████     ███
██████████     █████    ██████                                     ██████  █████    ███████████████████████████            ██            █████      ██
███████████     ████    ██████                                   █████       ██      █████████████████████  ████                         █████       █
████████████    █████    ████                                   █████                 ███████████████████    ███                        █████        █
█████████████   █████                 ██                       ██████                 ████  ████████████     ███                        █████        █
█████████████   ████              ███████                      ███████   ██           ███    ████████       ████               ██      ██████        █
██  █████  ███  ████             ████████                       ████████████           ██    ███████        ████             █████     ██████       ██
█    ██     ███  ██          ████████████                       ████████████            ██  ████ ███    ██   ████   ███     ██████      ████        ██
█           ███             █████████████               ████     ██████████              ██████   ███  ████   █████████     ██████                 ███
█           ████            █████████████              ██████     ██                      ████    ███  ████   █████████      ████               ██████
██         █████            ████████████               ██████                        ██                ███    █████████                        ███████
████      █████              █████████                  █████                                           █      █████████                       ███████
█████     █████                  ████                    ████                                                       ████                        ██████
█████     █████                   ███                     ██                                                         ████                         ████
████      ████                    ███                                                                                ████                          ███
████      ████                    ████                ████                                                            ██                           ███
███       ███                    ███████████         ██████                                                                        ███        ██   ███
███       ███            ███     ████████████       ████████                    ██                ██       ██                     ███████    █████████
████     █████          █████    █████████████     ██████████     ██           ████        ███   ████  ███████           ███   ███████████  ██████████
███████████████     ██████████  █████████████████████████████████████  ████   ██████   ███████████████████████████████████████████████████████████████
██████████████████████████████████████████████████████████████████████████████████████████████████████████████████████████████████████████████████████
