████████████████████████████████████████████████████████████
█ █  █ █ ██  ███   ██ ██     ████ ██ █   ██  █ █ █ █ █ █   █
█ ███ █  ███  ██████ █    █ ███  █    ██ █ ██  ██  █  █ ████
███  ███ ██   █  ███ █          ██ █ █   ██  ████   █████  █
█    █    █    █      ███ █     ██  █ ███ ███ █ █       ████
█ █   █ █       █    ██  █  ██ █ █  █  █    █   █ ███   █  █
██    █  ██ ██  █ █ █ ██  █   █ █   ███ ██         ███  █  █
█ █    ██     █  █    █     █ █    █  ██        █ █ █   █ ██
█   █ █      █ █        ███████  █████ █      █   █ ███ █  █
██ █ █ ██  █ ██ █ █ █ ███  █  ██  █    █  ██     ██ █ ██  ██
█ █    █  █ █ ████ ██ ██ ██ █    ██ █ █   █  ██   ██ █   ███
█ █  ██   ███ ██      ██      █    █ █     ████   █ █ ██   █
█ █   ███ █    █   █████ ███   ███  █    ██  █     ██     ██
█ █      ██ ██ ██   █         █ ███ ███ ████ █     ███   █ █
█     ██  █    ██  ██ ███  █  ████ ████ █████ ███ ██ █    ██
███  ██   █ ██  ██   █  █ █ █  █   █ █████  █  █ █    █ █ ██
█ █  █     █ █ ████ ██  █   ██   ██  ███ █  █    █ █ ██ █  █
███ ██  ███        █ █  ██ ████ ██   █  █ █ ██ ██ █████ █ ██
█ ██ █ ██   █ ██       ███  ██    █  ██ █      ██ ██  █ █ ██
█ ███  ██     ███ █████     █ ██ █ █ █     █ ██  █   █  █  █
█  █████ █  ████ █   █   ██ ██    █ █   █ █  ██  █████ █ █ █
█████ █  █         ██      ███ █   █   █      █  ██ ██ █  ██
█     ██         █████ ██  ██   █        █  ████       █   █
█  ███ █    █   ███   █  █  █   █  ███  ██  ███  █  █ █   ██
█ █ ████ ██ ██  █    █     █ ███ ███ █ █ █ ███  █  █     ███
████    █████   █ █ █ █████  █  █ █ █ █  ███   █  ██   █  ██
██       █ █ ██ ██  █  ████      ████ ██ ████ █   ██ █  ██ █
█  █  ██   ███  ██ █████   ██       █    █ █ █    █    ██  █
█      ███  ███ █████ █           █    █ ██ █  ██      █   █
███  █      █████   █   ██ █ ██   █ █   █   █ ██ █ █   ███ █
█ ██   ██ █   ██ ████          ██  ██  ████  ████ █  ████  █
█  █ ██        ████  █  █ ██ █ ██ █████ █  ████  █ █ █████ █
███ ███ █   █     ██    ████ ███  ██ █    ████   ██   ███ ██
█ █ ██   █  █  ██ ██     █  █████  █   ██  █  █ █    ██    █
█  █████████    █   █  ███     █ █   █  █   ███  █   ████  █
█ █ █ ███  ██ █  ██    ███  ██ █ █   █ ███   █   █  ██ █ ███
███████ ████   ██   █   ██ ██  █ █ ██  ██   ██  ██   ██  █ █
█    █ █ █ █ ██   █   █████  ███ ██ █    █ █ ██ █  █ ███  ██
██ ██      █  ███   █ ██  █   ██    █████ █ ██ █  ██ █     █
██  █ ███      █ ███  ███  █   ███ █ ████████ █ ██ █████  ██
█  █ █  ██    ██████     █   █   █   █     █   █ ██ ███ █ ██
█    █ ██  ██  █ █      █    ██ █    █ ███  █ █    █     █ █
█ █    █  █ ██ ███         █  █ ███   █  ███ ██ ██  ██ █████
████                 █  █ ███  ███  ███  ███   █ ██ █  █  ██
███  ██   █ ███     █ █   ██ █  ██   ██  ██ █ ████ ██ █  █ █
██ █     █     ██ █████ █   ██ ██████   █  ███   ████  █   █
█ █    █   █  █  ██ █ ██  █    █ █    █ █ █   ██████   █ ███
██ ██     ███     ███ ███ █         █  █   █   █  █     █  █
█  ███  ██ ██ █ ██  █  ██ ██     █  █  ██      █ █     ██ ██
█   █ ███ ████   █ █    ████   ██  ██   ██  ██  ████████████
█ ██ █ █ ███  █  █ █  ███    █ █    █ ██  █  ██  █ █   ███ █
██  █ █  ██  ███    █ ██     ███ █ ███ ██ ██   ██ █ █      █
███  █ ██████████  ██  ███             █    ███  █ █ ██  █ █
█  ██  █  █  ██ ███   ███        ██ ██  █      █ ██    ██ ██
█ ██         █████  █  ██    █ ██ █ █ ███  █ █  ███     ████
██       ███  ██  ██   █ ████    ██   █     █ █ █ █ █  █   █
█ ████   ██ ██  █████ █   █   ██ █   █   ██ █ ██    █ █  █ █
███  ██ █  ███ ██  █████████   █  █   ███      ███  ██ █████
█ █     █  ██  ████  █  █ ██ ██ ██  ██    █ ██    ██   █   █
████████████████████████████████████████████████████████████
