██████████████████████████████████████████████████████████████████████████████████████████████████████████████████████████████████████████████████████ █████████████████████████████████████████████████████████████████████████████████████████████████████████████████████████████████
███████████     ██████████████████████████████████████████████████      █████████  █████████████████████████████████████  ███████████████████████████       ██████████████     ██████████████████████████████████████████████████████████      █████████████████████████████████████████
██████████       ███████████    █████  ████████████████  ████             ██████     ██   █████  ███████   ████████████      ██████     █████████████         ███████████       ████████   ███████████████        ████████   ███   ████         ███  ███  █████████████████████     ████
██████████       ██████████      ███     █████████████    ██               █████                  █████     ████   ███        ████       █████████                ██████          █████       ██████████           ██████                                  ██████████████████        ███
██     ████       █████████      ███      ██████                           █████                   ████      ███               ██         ███████                  ████                        ███████              ████                                   ████████████              ███
█       ███        ████████      ██       █████                             ███                    ████      ███                           ██████           ██                                               ███               ████                        ██████  ███              ████
█                  █████████    ███       ██     ██             ███                  █    ██        ███      ██                            ███████         ████                                             █████        ███████████                        ████                    ████
██                  ████████   ████            █████            ████                ███  ████               ██                            ████████        █████                                             █████        ████████████     ██          ███   ████                    ████
███                  ████████  ████           ███████          █████                █████████              ███                    █       ███████        ██████                                              ███           ██████████     ██         █████ ██████                   ████
███                   ███████   ██           ████████████     █████                  ████████              ███                   ███      ████           ███████                                      █      ███              ████████   ███        ██████████████                   ███
███            █      ██████                 █████   █████   █████                    ██████               ███                   ███      ███             ███████                                            ███████           ████████ ████        █████  ██████       ███           ██
███           ███      █████                  ███     ████   ████                      █████         ██     ███                 █████    ████                ████                                           █████████████      █████████ ███         ████   ███         ████          ██
███           █████      ██                           ███████████                      ████          ███    ████             █████████████████                ███         ███                              ████████████████    ████████   ██         ████               ████          ██
███           ██████                                 ████████████                      ████    ██    ████    ████           ██████████████████                ███        ████                            ███████   █████████  █████████   ██         █████               ████         ██
███           █████            ███████              ██████████████         ██          ███     ███  ██████    ██            ██████████████████                ██          ██                            ███████     ███████████████████             ███████              ████         ██
████           ███             ████████   ██      ████   █████████        ████        ████     ████████████                  ██████████████████               ██                    █          ███       ██████          ███████████████            █████████             ███        ███
█████                          ██████████████     ██      ████████        ████        ████       ███████████                       ████████████              ██                    ███    ██   ███          ██            ███  ██████████           ███████████                      ███
██████                            ███████████              ██████         ███        ████          ██████████                       ███████████             ███    ███              ██   ████   █                                   ██████          ████████████                     ███
███████                            ██████████              ██████        ███      ██████               ████████████                 ██████████              ██     ████                  ████                                        █████          ██████  ████                     ███
███████████                         ███████                █████       ████      ██████                    █████████           ██    █████                          ███                   ██                                   █      ████                   ███                     ███
███████████                            ██                   ███       ████       ████                       █████████          ███   ████                                                                              ██     ███     ███    ██              ███              ██     ███
███████████                                                          ████        ███                        ██████████          █     ███           ██                                                                ████     ██     ███    ██              ███              █████   ██
██████████    ███          ██                                       █████       ████                       ████████████                ███         ██████                                                             ████            ███                    ███              ██████   █
███████████  █████          █                                      █████       ████                        ██████████████              ███         ███████    ██                              ██                      ████           ████                    ███               █████   █
███  ██████████████                                               █████        ███                         ██████████  ████  ███        █           █████████████                             ███                      ██           ████                     ███                 ██   ██
██    ██████████████                                              ████         ██                           ████████    █████████                   █████████████                             ████       █                          ███              █        █                       ██
██      █████████████                                             ████                                        ██████    ██████████                  █████████████                              ████     ███                         ███              █                                ██
██       ██████████████                            ███             ███    █                                   ██████    ███████████         ██       ████████████       ██                      ████   ████                         ███                                               ██
██        ██████████████       ███               ██████             ███  ███                                   ████      ██████████         ██       ████████████       ███                     ████   █████  █                     ███                                               ██
██              ████████      █████             ██████████            ██████                       ███                   █████████   ████   ███       ███████████       ███                     ████    ████████              ████               ██          █       ██              ███
██    █         █████████    ███████            ████████████           █████                      █████                       ███   █████   █████      ██████████       ███             ███      ███     ██████    ██         █████             ████        ██       ███            ████
██   ███       ██████████   █████████            ████████████           ████     █                █████                             █████    █████      ██████████     ███             ████               █████   ████         ████             ████         █       █████          ████
██   ███      ████    ██    █████████            ████  ██████            ███    ███                ███       ██           █          ███      █████      █████  ██     ███            ████                 ████   ████          ██              ███                 ███████          ███
██    ███     ███           ████  ██            █████  ███████   █             ████                         ████         █████                █████      ████         ████            ███                   ████   ██                          ███                  ███████████       ██
██    ████     █           ████               ███████  ████████████             ███                         ████         ██████                ████      ████        █████            ███                   █████                             ████       ██         ████████████      ██
███    ███                  ██                ██████    ██  ███████                                         ████         ██████                 ██       ████        █████             █                   ███████                          █████    ██████████      ███████████      ██
███    ███                                    ██████         █████                                           ██           ██████                        █████        ██████   ██              █           ███████                          █████     ███████████        ███████       ██
███   ███                                      ████                  ███            ███                              ██      █████  █                   ████         ████████████                         ███                    ███       █████     ███████████         █████        ██
██   ███                                        ██                  ███████         ████                            █████     ████████                   ██         █████████████                          █                      █        ██████     █████████   ████  █████         ██
██  ████                                                            ███████         ████                   ███      ██████     ███████    ██                        █████████████                                                          ███████    ███████    ████████████         ██
██  ███                                                              ██  ██         ████                   ████     ██████      █████    ████                       ███   ███████                                                         █████████  ████████    █████████████        ██
███ ███             ████                                                           ██████                   ███     ██████      ████     █████            ██   ██         ███████                                           █           █████████████████████    ███     ██████      ███
███  ███           ██████                                                         ████████                  ███    ██████        ███     █████            ████████        ███████                                          ███     █   █████████ ████████████████         █████      ███
███   █            ██████                                     ██                  ████████                  ███   ██████         ███      ███             ████████         █████                                          ███     ███   ███████   ████████████████         ████     ████
███                █████                                     ███      ██           █   ██           ███     ███   █████     ██   ████                       ██████          ██                                            ███      █      █████    ███    ██████████       █████    ████
████              █████                                    █████     ████                          ████     ███    ███     ████  █████                       █████                                                       ████              ████            ██████████       █████   ████
██████            ████                                     █████     ████                     █████████     ███     ██     ████████████                       ███                                 ███                    ████               ███            ██████████        ████   ████
███████           ██                                       ██████     ██                     ███████████             ██     █████  ████                                                           ████                  ████████             █             █████████         ████   ████
████████     ██                                             █████                            ████████████            ██      ████   ████                                   ███                    ██████                ████  ██                          ███████             ███    ███
███  ███    ████                                             █████                            ██  ████████           ██      █████   ██████████                            ████            ████    █████               ████                              ███████               ███    ██
██    ██   █████                           ███                 ████           █                    ████████                  █████     ████████                             ████          ██████    ████              █████                              ██████                ████   ██
██         █████                 █        ████                  ███          ███                    ███████     ██            █████     ███████          ███                ██████       ███████                     ██████                              █████                 █████  ██
███        ██████               ███      █████                  ███           █                      █████     ████             ████      ███            ███                 ██████     ████████                     ██████                               ██                   █████████
████        ██████             ███       █████      ██         ████    ██              ████           ███       ████              █████                  ███                  █████     ████████                      ██████                                    ██              ████████
████         █████             ███       ██████    ████      ██████   ████          ███████████                  ███               █████           ███                        ████      ████████                       ██████     █                           ████               ███████
███           ███              ████       ██████  █████      ██████   ████         █████████████                  █                ██████       ███████                                 ████████               ███        ██     ███       ██               ██████                ██████
██                            ██████       ███████████       ██████   ████         █████   ███████                           ██     █████      ████████                                 ████████               ████               ██      ████          ██████                     █████
██    ██                      ███████      ██████████           ███   █████       ███       ███████                   ██    ████     ███        ██████                                 ████████                █████                      ████         ██████                       ████
██    ███                     ██████       █████████             ██  ██████       ██           ████                  ████   ████                                                      ███████                   █████                     ████     ██████                            ███
██    ████        ██          ████         ███████               ██  ██████      ███            ███                   ███   ████                                                      ██████         ████       █████                     ████    ████                                ██
███    ████      ████          ██         ███████               ███  █████       ███             ███                  ██    ███                                                       █████          █████     ██████                     ████   ████                     ████        ██
████   ████      █████                 █████████                 █    ██        ████       ███   ████                ███          ███                                                  ████    ███    ████    █████                       ███    ███          █          █████       ███
████████████     ████████           ███████████                                 ████       ███   ████               ████         ████                    ██           ███               ████   ████    ████  ████          ██                    ███         ██         ██████      ████
█████████████    █████████         ███████████      █                            ██        ████  ████               ████        █████                   ████          ███               ████    ███     ████████          ████                   ████         █         █████    ███████
██████████████  ███████████        ███████████     ███                                     ████  ████         ███   █████     ███████                    ██████      █████        █    █████    ███     ████████    ██   ██████                  █████                  ██████ █████████
██████████████████████████████    ████████████    █████                             ██    ████████████  ██████████████████   █████████    ███            ████████  ███████████    ███████████  █████   ██████████  █████████████          ██    █████████              █████████████████
████████████████████████████████████████████████████████████████████  ████   ███   ████████████████████████████████████████████████████  ████████████   ████████████████████████  █████████████████████████████████████████████████      █████████████████████  ████████████████████████
█████████████████████████████████████████████████████████████████████████████████████████████████████████████████████████████████████████████████████████████████████████████████  █████████████████████████████████████████████████████████████████████████████████████████████████████
