████████████████████████████████████████████████████████████████████████████████████████████████████████████████████████████████████████████████████████████████████████████████████████████████████████████████████████████████████████████████████████████████████████████████████████
█   █ █   █  █  █ █ ██      █ ██   ██  ███    ██████████   █ █  █ █ ███ ██ █  ██ ██    ██  █   █  █     ██ ███ ██ █ █  █   █  ████ ███ █     █     █  ██         █   █       █ ███ ██  █        █  █ █    ████   ██       ████ ██ █  ███   █        █ █ █     █████ █ █ ██ ██████ █   ██
████     █ █ ███ █   █     █ █ █     █ █  ██  █   █ █ █ █   █   █ █ █    █ █ ██  █ ██   ███ ███  █  █  █   ██    █  █          ████  ███  ███ █    ███ █ █  █ ██  █  █  █ ██ █ ███ █ ██  █  █  █  █  ██  █       █ ██    █  █  █  █  ████      █        ██ ██ ██ █          █        █ █
█  █  ██  ██  ██ █     █            ██         █  █ ██    ████  ██  ██ █ █  █████   █  █ █       ██ ██       ██ █  ██  ██  ███     ████    █████ █   █ █████  ██ ██  █ █   █ ███   █  █   ██ ███ ███ █       █  ██ █ ███    █  █  ██ █████ ███   ██     █    ██   █   █ █ █ ██   █   █ █
█    █████  █  █   ██   █     █   ███  ██  █ █ ██  ███ ██ █ █   █ █  █ █      █ █ █    ██ █ █  █     █ █ ███ █████  █     ██   █   █  █ ███  ██ ██ █     █ ██   █  █ ███ █   █ █  ██   ████  █ ███  █ ███ ██ █  ██  █ █  █ █ █     █████ ███  █ █  ██ █████ ███   █ █      █   ██ █  ███
█ ██ █ █ █ ██ █      ███  █ █ ███  █ ██   █ █  █ █    ███ █ █   █   █ █ █     █  █ █     ██    ███ █  █ ██  ██      █     █   ██ ██  ██████ █  █   █ ████ █         ██ ███ █  █     ███ ██       █      █  █      █   █   ████  ███  █   █████ █████  █  ███   █ █    ███  █   █ █ ██  █
█ █   ███   ██    █ █  █ █ ██ ██   █  █  █     ██  ██  █    ██ ██  ██ █ █  ██ ██ █  █████   ████  █   █ █ █ █ ████   ██ █  ██ ██   █ ██  █ █ █ █ █         ██    ███ █  ████ ██  █    █ ████     █ █ ██ █ █ ██  █ ███ █       █ ██    ██ ████   █ ████     ██  █  █  █  █      █ █ ██  █
█  ████ ███  ████      █ █ █ █  █    █   █   ████  █ ██  █  █ █ █  █      ██ ██  ██ ██  █ █████ █ █     █         ██ ██  ██ ██ █     █  ████ █   █   ██ █ ██ ██ █ ███  █   █ █  ███  █   ███  █   ██ █      █ █ ███ ██ █  █    █       █ █   █  ██ ██       █  █   █   █ █   █  █ ████ █
█  █  ██ ██  ████     █ █ █ ██  █  ██ █ █ ██ █  █ █ ███ █  ██   ██ █   █████    ███ █  █  █ █  █   ██   ██  ███       ████ █   █  █  █ █  ██    █  ███ █     █ █ ██ ██ █████ █     ███ ██████ █ █   ██  █ ██  ███  █  ██  █ ████ █  █ ███ ███  ███ █ █ █ █  █  ████ █████  █ ███    █ ██
█   █    ███   ██████ █ ██       █ █ ██ █  ███ ████ ███ ████    ██ ██  ███     █  ██       █  █ █    ████  █ ██ ██  █ █   ██  █    ██  █   ██ █████  ███ █ █ ██ █        ███  ███  █ █  ████  █ ██ █ ███   █   ███ ██████ █ ██ ██     ██ █  █ █  ██ ██ █  ██ █    █ █  █ ███   ██  █  ██
█  ███ █ █         █ █  █  █ █    ██ ████   ██     ██  █ █  █  █ ███   ██ █ █ █ ██    ████  ██ █ ██ ████ █  █ ██  ██   █    █    ██   ███    █ █ █ █  █ █   ███ ██ █ ██ ██ ███  ██  ██ ██   █ ██ █ ██    ███    ██ ██ █ ██ █ █   █ ██ ██ █████  █ █ █ █ ██  ███     █    █  █   █ █  ███
█ █    ███████  █  ██   █ █ ███  █████ █ ██ ██      █ █ ███  █ ██   ██    ████  █  ██ █  ██ █ █ ███  █ ███████ ██    ██   ██ ███  █   █   ██   █ ██  ██        ████    ████       ██ ██ █ ██     █  ████ ██   █   ██ █ █      █ ██ ███  █ █   █   █ ██  █  ██ █   ██ █ █  █     ███  █ █
█  ██        █  █   █   █ █        ███  ██   ███     ████ █    █  ██ ██ ██   ██  █    █ █ █ ███  █   █  █ █   █ ██  ██ ███ █ ██   █  █ █ █    ██  █  ██    █ █     █ █    █ ██ █████ █ ████  █████ █  █ ██  █ █  ██  █    ██ █ █       █ █ █ ████ █  █ ██  ███ ███  ██  █ █      █     █
█  █   █  ██████   █   ███ ████ ██   ███  █ █ ███  █ █ ███  ████     ███ ██ █ █████    ██ █   █    ██████████ █  █   ███  ██     ███ █ ████ █ █ █  ██ █   █ ███     █  ██████ █       ███   ███  ██   ██ ██ ██  ██████ █     ███ █       █   ████ ██     ██████  █    █ █  █ █ ██████ ██
██ █     ████ █  █   █ ████ █ ██ █  █ █ █   █  ████ ███ ██ █ ███ ███  █  █     ███   ███ ███   █ █   █   █  █ ███  █ █  █ █  █  ██ █    █ ████  ██  ██████ █  ██ █ █  ███    █    ████         ███ █ ████        █ █     █   ██ ███   █  █  █   ██████ █ ███ █ ██  █ ███ █  █ ███ ██  ██
█   █  █ █ █ ███  █ ███  █  █  ██ █    █████   █  █   █ ██████  ███  █   █ ██ ██ ██ █    █ █     ██ █  █ █ ██ █  █████████  █ █    █ █    █  █ ███ ██  ███ █ ███   █████ █████ █  ███   █████ █ ███   ██  █     ███ ██ ██ █  █      ██ █      █   █    █      █   ███ █    ███ ███     █
██     █  ██   █ ████ █ █ █    █ █  ██     █  ██   ██   █ ███ ██    ██      ██   ██ ██ ██  ██    ██ ██    ███          ██   █ █   █  █████ ██   █  █      ███  ██ ██   █████    ██ ██ ██████   ████  ███ █   █  █ █ ██ ███ █  █  █  █      ██  ████ ███ █ █  █ ██  █████████ █████████ █
█████ ███ █    ██  ██ █   ███          ██    ██ █ █ █ █████ ██  █   ██ ██  ███  █  █ █ ██  █ █   ██    █ █  █   █ █  █ ██ █  ██   ███ █ █ ████    ██     ██  ██    ███ ██  ████    █  █  █  ██ ██ █  █    ██ ███ █ █ █   ██     █    █   █ ██ ██ █        █  █  █     █ █ ██    █ █    █
█       █ ██  ██    █    ██  █  ██    ███ █ ██   ███ ████ █      █  █  █ █   █            █      █   ██    ██  ███ ██     █ ███   ██   ██    █  ████ █  ██   ██ █  █ █  █      ██    █ ██  ██ █  █ ██  █  █  ███    █ ██ █  ███ █ █    █   █ █ ██   ████       █████ █        █ █ ██  ██
██ █ ███  █ ██ ██   █  █ ██      █  ██ ██ █  ██  █  █     ██  ██ ███  ██  ██ █  █  ███    █   ███    █   █████   █ ██     ██ ██   ██ ███  █ █ ██  █  ██ ██ ██ █  ██     █ █ █ █     ██ █      ██  ██ ██     ███  █    ██   ██     █   ██    ██ █ █   █ ██   █   ████ █ █     ██    ███ █
█  █  ██ ███ █  █    █  ██  █    █ █ ███ ██  ██   ██ █ █ ████   ██   ██  █    █  █  █ █ ████       ██ █ █ █ ██  █    ███  ██ █   ██  █  █     █   ██ █       ██   ███  ███ ████   █  █  █   ███  █████    ███   ████  ██ ████  ██  ██    █ ██ ██  █ ███  ███    ███ ██  █ █ █  ██████  █
█  █████ █   ██  ████  █  █████████ █   ██████   █    █ ███   ██        ████ █  █ █     ██     ██   █  █   ██ █  ███ █ █      █ █ █ █      █ ██   ██ █  █ █  ███ █     █   █   ████ ██ ███ █    █  █ ██ █  ███ ███ █████ █ █ ███     █████ █ ████ ██ ██  █  █    ██ █  █   ███   ██ ██ █
███ █  ███████ █      █    █   █  ████      █  █  ██  █      █    █ █ █   ██      ██   ██       ██  ████ █ ██ ███   ██    █  █   ██████ ██  ██       █ ██  █  ██    █ ██  ███   █  █     █   █     █ ███  █ █  ██     ████     █ ████ █ ███      ██ █  █ ███ █   █   █ █    █  ██ ██ █ █
██ ███ ██  ███  ██  ██ ████ █     █ ██ █              █ █  █ ██    █ █ █ █ █  ██ █  █  ███   ██     █ ██ ███ ██████ █      █   ██ ███       ████ █ ████  █   █    █████ █ ██   █ ██ ██ ██ █  ███   ██  █ ███ ████  ███ █  █       █ ███   ███     ██ █ ███ █ █ ██   █  █ █ █  █ █   ████
█  ████      █ ███ ███   ██ █ ██   ███ █  █  █   █       █    ██ ██     ██  █ ██  ██ █ ███ █ █   █   █ █ ██ ███  █      ██   ██ ██   █ ██   ██ █ ███      █ █ ██ ███ █   ██    █  ███  ██  █ ██ ██ ███    █  ██ █  █ █ █   ██   █ █   ██   ████  ██ █ ██   █  █ ████   ██ █  █ ███   ███
██  ███ █  ██ ██████ █████   ██ ██ ██   █ ██   ██      ██  █ █  █ ██████ █   ██   ████  █ █    ████       █   █  ██  █ █  ███     █ ███ ██ █    ███      █ █  ████  ██ █ ██   █  ██ █  █ ██  ███          █████       █ ███   ████   █ █      ██     █   █   ██ █  ██   ██     ██ █ ██ █
█████ █ ██ █   ████ ███ █  ████   █ ██ ███   █  █  ███   ████ █     ███  █   ██  █      █   █ ████ █   █ ██ ██   ██ ██ ███  █ █ █       █   █ █ ██ █   █   █ █   ████  ████ ███  ██   █ ██ █████ █ █ ██  ████     ██       █ █     ███   ███   █      ██████  ███  ██     █   ██   █ █ █
█████   ██████ █ █  ███ █  █ █ █     █ █ █    ██   ███   █  ██  █  █ ████ █ ██   █ ██  █ ██  █    ███   ███   ██  ██       █  █  ██████    █     ██   ███       ██          █  █  ██ ██ █ █████   █     ███ █    ███  ██    ██  ██ ██  █ █ █    █  ██  █ █   ██ █ █ ██  █ █  ███  █    █
█ █  ██   █████ █    ███     █ █ █  ███ ██     ██   ██ ██ █ ██ █ █ █    █ ███ █  ████ ███    █     ███    █    ██  ████        █ █ █ █ █ █ █  █████  █       █████   █ █   ██   ███  ████  █ █ ████   █ █  █ ██ ███ █ █  ████ █ █ █  ████ ███   ██  ██          ██   █████   ██ █  █  ██
█   █  █  █   █  █  █      ██████ █  ███ ██   █ █   ██   █  ██ ██ █ ██  █   ██ ███           █    █ ███ █ ██    ████  █ █ █ █   █  █████   █  █  ████     █     ██ ██ █  █ █ █ █  █    █ █ ███████  █  █ █  ███████      █   █ █ █ ██   █    █    ███ █ ███ ██ █ █ █ █ █████ ████  ██  █
█ █     █  █   █  █ ███ █ █ █  ██ ██   █ ██    █  █  ██   ██  ███   ███ █ █ ██  █   ███     █ █ ███  █    █ ██ █     █  █   ███ █ █ █  ██ ████ █   █  ██  ██████  ███       █   █ █  █ ██ █████ ██ ██ █  ██  ██   █        █  ██ ████ ██  ██  █  █    ██   █ ██ █ █ ██ ██ █  █ ██ █  ███
████ █    █      ██  █    █  ██ ███ █     ██ ██   ██ ███   █ █ ███ █  █    █    ██████  ███ ███ █ ██ ██     █  █  █ █            ███ ████ █ ██   █    █    ██  █  █  █████████ █ █   ████ ██████  ███  ████   █ ██ ██ █ ██ █ █ █ ███  █  █ ███  █  ██ ██ ██ ███ ████ ██  ██  █ █ █     █
█████  ██    █ █ ██  █ ██   ██     █  █  ██   ███  ██ ███   █    ██  █ █ █  ██ ██  █  █ █ ██   ██     █ ██  █  ██     ███ █   ██ █  █  █    █ █████ ██   ██      █       █   █    █  ██ ██ ███     ████ █ ███   ███   █     ████ █  █ █    ██  █  █████   █████ █  ██ █ ██ ███  ███   ██
█  ██  █  █ █  █ █ █ █ █  █ █ █ ██  ██      ███ █  █ █ █████████ █  █ █    █ █ ███  ██    ██   █ █     █ ██ █   █    ██████ ██  █ █ █ ██  █  █ █ █  ███████   ██ ██  ██ █    █ ██          █ █ █   ██  █ █     █  ██ █ █ █  █         █         █ █   █   █       █ ██   ██    ██ ███  █
█████ █   █ █  ██   ██  ██  ███  ██    █ ███████ █   █  █  ██ █ █  ████ █ █   ██   █ █ ███   █  ██ █ ███  ██       █ █  ██████  ███     ██ █ █  █████   █  ███ ███  █   █ █ █ ████   █ ██ ██ █ ██  ███   █ █   █           █ ███  ██   ██   ██     █ █ ██  ██    █ █  █ █  ██   █ █   ██
█   █ █   █   █  █    ███    █ █  ████ █ █ ██ █ █     ██    █ ████   █ █  ███  █      █      █ ██  ███ ██   █ ██████   █ ███ █ █  █  █  █  █ █ ██ ████  █     █   █    █ ██  █ ███ ██ █ █ ██     ███ █  ██████ █ █ ████ █████   █ ████    ████   ██  █  █  █  █  █  █  █   █  ███   █ ██
█ ██ █ █      ██  █ ██ ██     █ ████  █    █    ██  ███ █  █   █ ██    ██      █ ██    █   █ ███ ███         █ ██ █  █  █     █ █      █  ██ ███ █ █   █ ███ █  █ █   █  ██ █  ██ ██ ██ █    █ ██ █   █ ██ █  █ █████ ███ ███ █ ██  ███    █ ███ █████          ████ █   █ ████  ██   ██
█  █  ████  ███ █ ██ █ █████  ███  █   █ █ ██ █ ███  █ █    ████  ██   ██ █  ██ █ ██ █   █  ████   █ ██   ███ ███  ██ █  █   █  ██ █       █ █  ██     █        █   █ █    ██ █  █ █ █ █    █ █ ███ █   ██    █ ██ █ █  █    ███     ██  █ █  █ █ █   █ █   █    █ █ ██   █   ██ █  █  █
█████ █      █ ██ █ █ █ ██ █  █    ███ ██   █   ██ ████ ██ █ █ █  █       ███  ██ ██ █ ██   ██ ██████ █ ██ █    █      █ █  █ █  ██  ██ █ █  █ ██████ ██ █ █   █  ███   █ █ ██ ███  ██ ███    █  █  █  █ █    ███         █   ████   ██  █  ██   ███ █  █       ████ ██ █  █   ███   █ █
█  █ ██  ████   █  █  █   █ ███ ███ █  ████ █   █   ██ █ █  ██  █  █ ████ █   █ █ ██ ████ █ ███  ██ █ █    █ █    ████ █   ██   █ █ █   ██    █      █  █      ██  █  ██ █ ███ ██  █ █      ███   █  ██   ███      ██  █  ███ ██      █   █ █ ██      █ █    █         ██  █    █ ██████
█ ████   █  ███    █  ████ █████ █ █   █ ██ ██    ███ ██   ██   ██ █  █  ██████  █  ██   █ ████ ███    █ █       ████  █ █ █ █  █  ███  ███  █ █  █ ███ █ █ ████    █  █    █ █ ██  ██      █ ██  █ ██    █ █ █     ██ █       ██  ██  █    █ ███  █ ██    ██     █ █ ███ █ █ █    ███ █
█ ██     ████       █ █ █ ██    ███  ███   ████  ██ █ █ ██  █  █ █  ██ ███ ██████ █  ████    █   ██   █     █  █   █  ████████ █  ███  █ ██ ███  █    ███ █     █ █  █    ██ █  █ █ █ ████ █   ███ █  ██ ████ █ █ █  █  ██   █   █       █ █  █  ██  █ ██ ███ █ █   █  ██ █ █ █      ███
█ █  ███████  █  ██         ██ █ █████ ███ ██ ██         ██   █ █   ██ █  █  ██   █  █      █  ██  ██    █████  ██ █  █     ██ █  ██ █   ████ █  ███     ███  ██ █     █   █   ██████ █      █ █     ███    ███      █  █     ██          █   █ ██ █████   ██  ██ █      ████      █ ███
████ █ ████ █    █ █    █ ██ ████      █ █  █ █ ██ █   █ █████        ██  ██ █ █   █  █  ████       █ █  █ █   █ ██ ██ ████  ███  █████  █  ███ ██  █  █  █ ██ ██               ██   █     █    █████ █  ██ █   █ █   █   █   █  █ ██ █   █  ███  ██ █  █ █ ██████ █   █   █   ██ ███ ██
██   █ ███ ██   ██  █ █████  █    █    █  █   ███ █ █ ███   ██     █  ██  █    █  █      █   ██    ███  █ █ █ █  ███  ███  █       █  █ ██   █ ██  ██ ████ █  █    ███████    █     ██ ████ ██  █        ██    █     ██ ███ █ █  █ ██ ███     ██  █ ██    █   █   ██  █   ████ █████  ██
█████    █ ██   ███  ████ █ ██ █   ██  █████  █  █ █  █ █████ ███   ██ ███  ██ █   █  ███  █    █   █ ███   ████   █ ██ █    █ ██ █   ███    ██ ██  █████ █████  █     █   █  ██    █  ███  █   █   █  █ █  ████      █  █ █  █  █ █  ██  █  █  █     ██ ████   █████ ████ ██  ██     ██
███ █     █   ███████  █  ███  ███     █  █  ██  ██   █ ███ ███ █ █         █   █ █ ████ ██ █    █  ██ █   ██   ███ ██ ██  ██ █     █████  █  █ █ █ █ ██ ████  ██ █ █ █  █████ █  █   ███ ██  █  █   █  ███   ██    █   ███ ███  █ █ █ ██ █ █    ██   ██    █  ██   █████ █  █ ███ █  ██
███████   █ █ █ █  ██       ███  ██   █    ██ █████ █     ████ █ ██████ █  █  █ █      █ █████  █ █   █  ██     █       █   █ ███    ██ █ █ █████  ██  ██  ██ █████ ████ ███  █ █  █   ██    ██ █  █ ██ █████    ████████████  █    ██   █ █  █   █ █ █  ███   █    █ ██  █  █ ██ ██   █
█  █████  █  █ █   ██  █ █     █  █ █ ██  █ █    ███   ████   ██ █ █ █ █ ████   █  █ █ ███ █ ███  ██   ██  ██████     █         ██ ██  █  █  █ ███ █ ████ ██     ██    █   █ ███ █ █ ██ █ ██ █    █  ██████   ██  █ ██  █ ██  ██  ███ ██ ██   █ █ ██       ████ ████ █ █ █      █ █  █ █
██████ ██ █  ██ ██ ███  ██  █  █ █ █  ████     ██ ██  ██  ███       █     █    ████ █████ ██    █     █████  ██████ ██   █   ███████ █ █ ███████    █   ██        ██    █   █ █ █  ██   █  ███          █ █   ██   ███ ██  ██ ██ ██ ████ ██ █ █ █ █ █     ██████  █   ██        ██████ █
█ █        █ █ ███ ███       █████ █  █  ██        ██   ███           ████ █████ █ █   █  ██ ██ █   █ █    ██ █ █ █  █  ███  ██ █  ██ ████    █   ██   ████    ██   █  ██    █ █    █     ██ ██ █  █ ██ █ █  ██  █ ██   ███  █  █ █ ██ █████ █     █ █ █   ██ ██ ███   █    █ ████  ████
██ █     █     ██ █       █    █  █ █ ████ ██ █ █ ███ ██  █     ████  █   █  █  ████  █  █  █  ██ █ ██  █ █ █         █   █████   █  █      █  ██ █ █   █   █ █ ██ ██████     █████ █  ██       █     █ █     █   ██ █ █ █   █ ██ ██          █      ██ ████ █ ███     █   █   ████   ██
██ █ ███████ █ █ █ █ ██ ███    █ ████     ██ ██   █      █  █   ███  ███       ██ █ █ █  ████ ██ ██   █ ████  █           █ ███    ███    █ █ ███ █  █ ███ █    █ ███  █ █   ██ █  ██    █ ██ ████  █       █  █   ███ █ ██ ██████ █  █  █  ███    ██ ██     ███ █  █         ████  ██ █
█  ██ █ █ █ ███     █████ █    █ ██   ███ ██ ███████ █    ██  █   ████ █ ██ ██ ████ █ █ █   ███       ███  █  ██ █   █ █   ███ █       ██ █    █ █   █    █  █ ███ ██  ██  ██ █ ██  ██  █  ██  █  ██ ███ █ ██  █    █ █  ███ █  █  █ █  █       █    █ █      █  █ ██████████  █  █ █ ██
██ █     █ █   █ █  █  █████   ███████ ██ █    █ █   ██████ ████ █  █    █   █ █          █ █   ██  ██ ███  ██     █  ███  █ █ █  ██ ██ ███   █ █ █ ██ ████    █ ███  ████   █ ███   ████ █ █ ████  █  ██ █    █   ███   █ ██ ████   █ █ █ ██  █ █  █   █        ███   █ █  █ █ █ █  █ █
██    █       █ █     █   █ █ █  █ ███  ██   █  ███  ██ █ █   ██ ████ ███ ██ ██ █  ██  █ ████ █    █ █   ██  █ █ ██ ██    █   █  ██ █     █   ███     ██ █ ██ ███   ██  ██ ███ ████ █ █ ██ █  ██ ██  █   █ ██           █  █   ██ █████  ████  ████ █      █  █  ███ █ ███ ██       ██ █
█   █  ██   █    ███   ███ ███     ████  █ ███    ████   ██ █ █  █  █  █     █   █████ ██  █  █ █ █    ██  █████   ██ █  █  ███████  ███   ██ █ ██   █████████ ██       ██   ███  ███    ██ ████ █  █ █   █ ██ █ █    █ ██    █ ██ █ ███   █    ██ ██  █  ████  █   ██ █ █ █    ████ █ █
██      █ ██  █      █ █ █ ██ ██     ██        ██ ██████ █      █  █ ██    █     ██  ██ █   ██ ███            █ █  █ █ ██ ██    █    ███  █ █  █    ███ ██   ██ █ ██    ███   ██ ██   █   █ █████ █ ██ █ █   ██ █  ████████ █ ██    ██ █     ███ █   ██ █       █  █    █ █  █  ███ ██ █
███  █   █    █ █  █  ██ ███ █ █  █     ████   █ ███     █ █ ████   █ █    ████  █ ██ ██  █   █ ███████  █ ████         ██   █ █  █  ██ █ █      ██   ████ █      █ █    █  ███ █    █ ██  █   ██ ███  ███  █ █     █      ███ █ ██ ███ █ █  █  █  ██ █ █ ██   █ █  ███ █    █ █    █ ██
█  █     █ ███     █ █ █ █ █  █   █ █   ██████     ████ █ ███   █   ███ █ ████        █ █ ██ █ █  █   ██   █ █   █   ██   ███    █ █      ██    █  █ █ ██     █    █         ███  █ █  ██ █ █     ██████  █  █ █████   █  ██   █ █   █  ██     █      █ █  █            █  █  ██   █ ███
█ █ █  ███  █ █  ██ █  ██  █       ██   █ ███████  █ █ █ █ █  █ █████ ██ █████ █   █ ██         ██      █   ██ ██ █ █ ███   █ ██ █ ██   ████ █ █ █ █  ██ █ █ █  ████   █████   ██   ████ ███            █    ████ ███ █ █████    ██     █    █   ██   █   █  █ █   █   ██ █ ██  █ █ █  █
█   ███  █  ██    █    █       ███    █     █  ██  █████     █  █ █  █ █  ███   ███ ██ ██ █  ██ █   ███       █  ██ █ ███ █   █  █  ██      ██ █  █     █  ██    ███ █       ██  █ ███ █ █ █    █ █████  ███  █ ██  █ ███ ███  ██  ██      █  █ ████ ██  █████    ████ █ ██  ██  █  █ ██
█ ███    █    █   █     █  █  █ █ ██ ██ █████ ███ ████ █  ██ █       ██ ███ █  ███ █ ███ ███    █ █ █  █  ██ ██ █ █    ███ █    █  █  ███   █ ███ █    █ ██    ███    ███ █ ██ █ █ █   █ ██   █ █   █ ██    ██          █  █ █ ███  ██  █    ███  █ █   ██  █ █ █ ██         ████ █  █ █
█   █   ███  █    █████ ██ █ ██   ██ █     █   █ █ ██ ██   █   ██    █ ███  █    █     ██     █ ██ █  ███████ ███    █████ █    ███    ████ ██  ██  █  ██    █████  █ █     █ █ ███       █  █  █    █████     █ ██   ██ █ █      ███ █      █ ██  ███ █ █  █ █  ██  ██ █  ██ █   ██   █
█   █     █   █ █  ███ ██   ███         ██  ██  █  █  ██ █  ████ ███████   ████  █  █ █ █  ██ ██     █  █ █    ██ █  ███         ███████   ██  ████ ███   ██  ██ █        ███  ██    █       ██████   █      █ ██ █ █ █ █    █  █ █ █ █ █ █     ███████  █       █  █  ████    █ █ ███ █
█  █  █        ███  ██ ██ █  ███  █ █ ███ ██ ████       █   ███  ██ ██ █ ██  █    ███  █   █   ████     █  █  █ █  █ █ ██  █ █    ███  █  ███   █  █ █    ██  ████ █   ██  ███    █ █  ██  ██ ███  ██ ███ █     ██ ███   ██ █ █  █ ██    ████    █  █ ████ █  ███ █  █ ██    ██  █   █ █
█ █  ██           █ ██  ██ █ █  ██ █   ██    █ █        ██       █    █ █       █     ████ ██       █  █    ██   █ ██      ██ ██  █  █ █ █ █       ███   ███ ███ █ ██  █  █  █   ██  ██ █ █  █ ██ █ ██ ███ ██ █ █  █  █  █     ██   █ ████  ██  █  ██   ███ █   █████   ██ █  ██  ██ █ █
████████████████████████████████████████████████████████████████████████████████████████████████████████████████████████████████████████████████████████████████████████████████████████████████████████████████████████████████████████████████████████████████████████████████████████
