████████████████████████████████████████████████████████████████████████████████████████████████████████████████████████████████████████████████████████████████████████████████████████████████████████████████████████████████████████████████████████████████████████████████████████
██    ███████ █  █ ██  █   █       ███ ██ ██    █ █     █  ██    ███   ████ █ █ ██    █  █      █  █  ██ █  ██ █ █ █  ██  ██      █    █  █          █ ██   █ █ ██  █  ████ ███   █████        █ ██ ██ █ █  █   █  ██ █  ██ ██   █ █ █   ████ █ █ █   █ ██ █ ████ ████ ███ █ ███     █ █
█  █   █  █ ███   █   █ █ █ █      █  ████ ██  █  █    █   █  ██ █ █████ █ █ ██       ███████   ██ █ █  ██  █ █ ██  ████  ██ █  █    █  █   ████ ██  █    █  █  █  ██ █  █  █   █   █  ██ █ █    █  █ █   █    ██ █      █ █ █    █   █ █ ██    █ █     █ █ █  ████      █     ██ █    █
██    ███     ██ █   █   ███ █ █  █  ███  █ █ █  ██  ██    █ █  ██   █ █  █ █ █   █   █   █     ██   ███   █  █ █ █  █ █ ██     ███   ███ █     █   ██ █ ████ ██ █ █  █  █      █   █  ██   ██ ██     █   █  ███ █        ██   █      █ █ █        █  ██    ██ ██ ██ █ ███  █ ████  ██ █
███  ██ █  █    ██     █ █  █  █       █  █    █ █         █     █   █  █ █ █   █ █  █████ █  ██   █ ██       ████ █ █ ███  █████     █  █ █    ██ █  █    █ █   █ █ ██         █ █  █    █ ██ █    ██ █   ██ ██   ██  █   █ ██████ █ ███ █  █ ██   █    █ █████ ██     ██    █  ██ █ ██
██ █ ██ █ ██ ██        █ █ ████ █  █  █   █ ██  ███████    ██  ██ ██   █  ███ █  ███ ████     ███          █ █   ███ █ ██  █   ███ ██  █ █      █ █ █ ███  █   █      ███ █  █ ██ █   █ ███  █ █       █  ████  █       █   ██  █  █  ██   █ █  █ ███  ███  ████   █  █   █ █ █ ███  ███
██ ██     ████  ██ █ █  █  █   ██ ███   █      █  █  █  ██     █ ██  █ █ █ █   █ █        █████    ██  ██  █ ██  █      ██  ██  █  █   █  ██ ██      █   █  █  █     █   █  ██   ███ █ ██   █     ████ █    █ █ █ █ █ ██    █ ██ ██     ███████  ██ █ ██ ██ █ █    ██    █ ███ █ █   ███
████ ███  ██     ██ ██   █ █ █ █   █ █    ███ ██    █  █  █  █ ██ █   █   █ █ █  █ ██ ██  █ ███ █  █  ███   █████  ███ █ █ ██   ███ ██       ██    ██ ██ ██  ██     ██    ███ █ █  █  ██ █ █ ██████  ███ █ ██ ██ █     █ █    █    ███  █████ █ █ ████    ██   █ █    █    ███ █  ██  ██
██ █ █ █ █ █   ██ ██  ██ ██    ██       █   █    █ █  ██   █ ██  ██  █   █ █ ███  ██ █  ██  ███    █   ██  ██   █ █████     █   █    ████  █  █ ███ █      █  ██  █ ██  ██     ███ ███  █ █ █ █   █    █   ██ ██ █  ███   █ █  █  █    █ █    ███  █ █ █████ █ █ █ ██ █ █       █ █ ██ █
█      █     ██   █  █████  █   ███   ██  █ █  █ ██   █ █   ██  █   █  ████ ███  █ ██████  ████ █  █ ██  █      █ █  ███     █    █  █   █ █  █      █ ██ ██  █ █ ███   ██████ █    █ ████  █ █ █    █ █   ██ █   ██ █       █ ██ ████  █    ██     ██    ███   █  ██  █ █ █    █  █  ██
██      ██   █ █ █  ██ ██████  ██ █ ██  ███  █     █   █ █  ██ █   ██    ███ ██ ██ █  █  █    ██ █   █ ██ █  █  █ ██ ██  ██  ██         ██ ███  ██   █ █ ██    █  █       █ ██ ███  █  █ █  ███  ███ ███   █ █   █ █  █       █ █ █    █ █  █   █ ██  █ █ ██    █   █   ██ ██    █    ██
█ █  █ █   ██  █  ██  █ █  █ █ █   █  █  ███ █  █  █ █ █ ██ ████     ██ █   █  █  █    ██ █ █  ███ █ █    ██ ██  █    █ █ █ █         █ ████     █ ███  ███ ████████ █  ███ ██  █ █  █ █    █ ███  ███ ████ █ █  ██   ██ ██ █   ██       █ █  █ █  █ ███  ██ █ █ █████    ██ ██   ███  █
█ █ ████     ██   █ ██ █     █████   ██████    █  ██  ██ █   █  █ █     █ █ ███ █ ████  ██  █  █ █   █    █  ███ █ █ ████   █ █    ████ █ █    █ █ █  ██  ███████ ██     █ █████ █ ███   ██████   █  ██ █ █   █  █  █  █    █ █  ████   ██ ██  ██  █  █  █  ██  █ █ █   ███  █  █ ██   █
█ ██  █ ████ ██  █   █ █   █  █████ ███      ███   █ █   ██ █████ █ █          █████   █     █    █ ███ █  █ █  ██      ████ █ █ █  █  ██            ██     ████  █  █    █         █  █ ████     █ ██ █  ██   █ █  ██   █ ███ █   ██ █   ██  █ ███ █  ██ █ █     ███    ██ ██     █████
██ ██ █  █ ██ ███ █  ██ █   █  █   ███    ███ ███ ██ ████ █ █  █  █   ████ █  ███  ██  ██  ██ ███ ███ █ █    █   ████  ██ █  ██  ███   █ ███  ███ ██ █ █   █     █  ███ █  █  ██████ █ █    █ ████ █ █ █     █   ███ █    █ █ ██ ██    █   ██  █    ██       █ █ █     ██ ██ ███ ███   █
█   ██ ██ ████  █  ███ ███ ██   █    █   █    █      █  █ ██    █    █  █ ██   █ █ █       █ ██ █   █ ███ █ ███  █         ██  █   █  █ █  ██ █    █   █ █  ██    ███ ██ ████  █  ███ ██ ███ █    ██████  ███████  ██ ███   ██ ██ ██   █ ███ ███  ███████  ███  █  ██ █    █ █      ████
█  ███ ███  █ ███  ███ █   █████   ███  ██  █ ██ ██ █   █ ███ █████   █  ██    ██ ██  █       █ █ ███    █ ███ ████   ███    ██   █     ███ ███     █ █ ███  ██   █ ██ ███   █  █  █ █    ███  █  █   ███ ██  ██ █ ██  █    █ █    ███ █           ██ █    █   ████ █ ██ █   █ █ ██ █  █
█  ███    █ ██  █ ██  █            █ ██ █      ██   █ ██ ████ ██ █       █       ██ ████  █  █   █████████████   ██████  █  █   ██  ███  ██ ██  █ █    █  ████ █            ██      █ █  █████ █      █ ██   █ ████  █     █████  █████ █ █ █ ██ ██      ██  █ █    ██ █ ██ ██   ███ █ █
█       ███ ██    █ █   █     █ █         █    █ █  ██   █ ██   █     ██  ████ ██   ██  ██ █ █  █  █  █      █   █    ██    ██ █  █████ █    █  █ █ █████ ███    ██  █      █  ███ █   █   ███ █  ██ █       █  ███          █ █ █ █ █ ███     ██  █   █     █  ███   ██ █ █   █  █    █
██ ███ ████  █ ████    ██  █ █   █ ████ █ █  █       █   ███      █  █ █  █  ██ ███ █      █   ████ █  █ ██     █ ██  ██   ██  ███  ███   ███ █  ██   █  ██   █ ██ █    ███  █   ██  ██ █ █     █  ██ ██   █████        ██ ██ ██ ████  ██      █ █ █  █   ██ ██ ██       █ █   █  █   ██
██ █      ██████ █     █   ██   █   ██  ████     ██  ██        █ █ ███   ██    █   ███      ██      ███ █ █ ██████  █   █ █   ███   ███    ██          ██ ██ █  ███ ██  ██ █  █       ███   ██ █ ███ █ █  █ ██    ████ ███  ███ █  █  ███       ███   █  █   ██  ███    ███        ███ █
█ █████ █  ██ ██  █  █  █ █████ █     ██  █ ██     ███ █ ██ ██ ██    █ █ ███ █    █ █ ██ █ █  █   ███ █ ███ █  ██ █    █   █  █  ███ █    █  █  ██    █ ██ █   █  █  ██ █   ██  ███ ████    ██ █   █   ████ ██ █  █  █  ██  █ █  ███   ██    █ ██  ██████████████  █ █ ████  █     ██  █
█  ██ █████  ███ █    ███    ██ ██  ██ █    █ █   █    █ ██ █  █ ██  ██  ██   ██ ████ █  ██   █ ██ ████ ██  █   █ ██ ██  ████  ██  ██     ██ ████    █    █    █  ██ ██ ██  █   ██ █    █ █    █      ██ ██ █ ███    █ █  █ █   ██  ██   ██ ██████  █     █      █   ██ █ █   ██ █ ██ ██
█ ██   █ ████     ██ ████ █   ██ █     ███   ██  ████   █     █   █ █ █  █  █  ██  █ █ ██  ███     █ █ ███ █ ██  █  █ ███     █ █  █ █ █ █ █  ███ ██       █ █ █ █ █  ██  █ █     █ ███    █ ██    ██   █  █ █  ██      █     █ █████    ████ ███  ██    █ █      ███  █    ██   █    ██
█ ██████  █ █  █     █  █   █ ██ █ ███    █  ██  ███  █  ██  █  ██ █████ █    ██    ███ █    █  ██ ████ █   █ █   █ █ █    █  █  ██      ███ █ █   ██ █ █ ████  █  █ █  █ ██ █   ██ █ █   ██  ███ █  █ █ ████ █   █  █   █      █   ██████        █████   ████       █   █ ██    █  ████
█  ██    █ █     █  ██   ██     █ █  ██ ████   ██ ██ █  ███  █     █ █ ██ █ ██       ██ █ █  ██  █  ██      █   ██    █████     ██  ████ █ █ ███ █ █   █  █████ █  █     █     █  █ █      █ █   █ █ ████  █    █  █ █████  █  ██████ █ ██  █ █ █  █  █  █       ██████ █   █  █ █  ████
██ ██ █   ███ █    ███ ██       █  ███ █    ████ ████    █ █ ███   ██ ██  █  █    ██ ██ ███      ████        ████    █ ███  █ █████  ██   █  ██   ███   █████    █ ██  █     █  ███ █  ██ ███ █ ██  █ ████ █  ██ █ ██   █ █ ██ █ █ █ █  █ █   █ █ ██ ██   ███   ███ █ ███     ████     █
███████    █ ██    █      ███   █  ███     ██ ██ █  ███   █  ██ █ █      █ █ ███  ██ █    █  █  █ █   █   █   █  ███    █     █     ███   █ █ █ ██ █     █ █      █ █   ███  ██  █ █  █    ██    █       ██  █    █   ██ ██ ██ ███ ███ ███         █ ██ ██ █ █ ██  ██   █ ███ ███ █  █ █
█   █  █  █  █ █████   █  ██  █ █    █    █ ███ ███████ ███ █ ████ █ ██ █  █ ██ █ ██ █   █ ███ ██ ███  █    █ █ ███ ██ █   █      ████   ██████   ██ █  █       █  ██   ████ █    ███ █  ████  █ █  ██     █  █   █ █     █ ██ █ █     █   ██ ██    ███ █  █ █ ████   ████████  █████ ██
█   █      ██████ █   █ ████   █  █ █   ██ ██  █  ███  █  ████ ███  ██  ███  █   █  ███████ █  █ ██  ███ ██  ██  █ █ █ █ █  █    █ █       █  █   ███  █ ██ █   ██  ██ █    ██      ██  ██          █ █  ██  ███ ██        ██    █  ██   ██ ██ ████ █ █ ███       █ █ ████  █ █      █ █
█ █ █ ███ █ █ █ █   █          ██ ██  █  █ █  ███ ██ █ ███ █  █     █  █    ██  █     █   █     █   █  █        ███ ██   █ █   █   ██   ██  ██     ███  █████  ██ █ █ █ ██  ██ █ ██  █ █  ██ █  █     █ ██   █ █ ██  █     ██   ████  █    █  █ ██   ██  ███   █ ██ █   █     ██ █   ███
█ █ █ ███  ███ █ █ █████  █ █ █ █   ██████ ██ ███   █  █ ██ ██ █      █  ██ █   █ ███ █ ██    █ █    █    █   ██ █   █ ████ █ ██   █ █   ██ █   █     █ █ █  █   █     █   ██ ███ █   █   █  █    █  █ ███ █        █ █  ███ █ ███ ██     █ ███ █  ██████ ████   █     ██     █  ██ ████
█████   █ █  ██    █ █    █ ██   ██  ██ █ █ █ █ █  █ ██   ███ ███   █   █ ██    ██ █  █ █    █    █    █  █ █    █ █ █  ████   ██ ██  █ ███   ██ █    ██   ████  █      █   █  ██  █ █ █  ██            █ ██ █      █ ███ ███ ██    █  ██  █  ████ █  ██  █  █   █████ █    ███  █ █ █ █
██    ██ █  ██████ █  ██ █ ██ █  █     █████  ██  █  █   █ ██   █ ████        ██    █ ██ █ █ █ ██    █ ██   █   ███ █ ██     █████ █    ███ ██    █ ███ ██  █ █  ██  ████  █    █  █████        █ ██      ███ ██ █  █   █  ██     ██  ██  ██     ██ █ █ ██ ████      ███ █  █      █  ██
███   ██    ██ ██   ██   ███ █  ██     ██  █  ██ ██  █  ████ ██    ██ ██    ████ █ █  ██      ████  █  █    █ ██   ██   █ █    █     █ ███ █   █ █  █    ██   ██ ██      █  █ ██    █████   █  █  █ █ ██ █ █ ██    ██    ███   █ ██   ███ █ ██   █    ███ ███ ██     ██ ██     █   █   █
██  ████ █   █   ██    █   ███   █ █ █  ██   █ ██ █ █  █████ █ █  ██ ██   █ ███             █  █ ██  █     █  █ ██  ████ █    ██ █   █████    █████  ███ █  ██  █   █ ██ ██    █ █    █  ████ █    ███  ███ █    █  █        █ █ █   █ ████  █ █  ██  ███ ██████ ███ █  ██ ████ █     ██
███ █ █       ██       █ ███ █ █           ████    █ █ ██ ██ ███  █  █ ██   ██ █ █    ███  ██           █  █    ██ █    █ █  █ █    █  █ █ █  ███  ██ █  █ █  ██    █ ████ ██  █  ██   █  █ █ ███ ██████ ██       ██    █ █ ██ ██ █     ████ ████      █ █   █ █      █ ██ █       ██ ██
█ ██ █   ████   █   ██     ██  █ ███    ████ █   █ ██  █  ██   █    ███     █ █  █ ██     █ ██ ████   █   ███ █      ██   ███ ██  ██ █  █████   ██ ██ ██   █ ████ █      █ █ █ ██████  █ █  █     █ █████ ███ █ ██ ████   ██     █ ███ █   ████ █     █████      ███  ██  ██  ███ ██  ██
█  ██   ██ █ █ ███████  █████     ████ █ ██  █ █ ██  ██  ██   █ ██████ █ █   ██  █ █   █ █ ██   █    █  ███ ██  ██████    █ █      █ █       ████   ███ █   ██ ███  █ ██ █  █   ██      █   █ ██  ███ ██  █ █    █        ██ ████ █ ██         ██ █    █ ██ █ ██     ██ █ █ ██ █  █   ██
██ ███   █ ███ ███ ██  █ ██ ██  ██  █ █  ██ ██   ███     ███  ██ ███  █    ██  █  ██   █ ██ ██  █  █ █     █       █   █    █  ███ █  ███ ██   █ ██  █ ██ ██ █ █   █      ██ ███  █   ██ █   ████ █  █ █ █    █ █  █ █ █ █ █ █ ██  ██ ███   █ █ █  ███ █ █  █ ███ ████             █ █ █
█ █ ████ ██ ██  ██   ███  █ █ █████    █ ████ ██ ██  █ █  █ ████ █ █   █ █   █ █████  ███  █   ███  ████  █ █    ██      ██  ███ ██ █ ██ ██  █    █   ██       █ █ ██   █ ██ █    ███████  █ █   ███ █████ █    █ ███ █ █  █  █ █  █ ██  █ ██ ███     █    █ █     ███  ██   ██ █ █ ██ █
████     ██ ███  █ ██  █ █  ██ █ █ ██ ██   ██  █  █ █ ██ █   █ ███ ████  █ ██ ██  ██   █████ ███  ██ ██ ██ ███   █   ███ ████   █      ██  █ ███  ██   █   █ █      ███ ██  █ ████ ██     █    ██ ████ ██      ██  ████ ███ ██    ██ █ █     █  ███ ██ ███   ███████ █      █   ██ █ ███
█ █████  ██   █     ██ █████         █ █     █            ██ █   █ ██   █   █ █████   █ █     █ █   █ ██ █ ███ ██ ████ ████     █ ██ █   ███ █ █ █    █ █  ███ █████  █  ███ █ █   ██ █ ███   █ █████ ██   █  ██    █ ██ ██████  █ ███       █ ██ █  █   █  ████ █   █ █ ███ █  █  █  ██
█   █     ██ █ █   █        ███    █  ██  █ ████ █  ███  █  ███ ██    █  ████   █ ████ █   █     ██ ██ ██  ██  █    █   ███ █      █ █ █ █ █ █ ███     ████ █  ██ █ █ █ ███   ██   ████  █ ██ █  ██   █  ██ █    █ █ █  █   █ █ █ █   ███  █ █  ██  ███  █ █  ██    ████ █ █   ███ █   █
██  █   ████  ███ ███ █████  █ ███  █      █  █        ██  █   ███  █    █  █  █    ██  █ █ ██   ██ █ ████    ██ ██  █  █ ██ █   ███   ██  █ █ ███  █ ███   █   ██  █ ██  ██  ██ █  █████  ██ █ ████     ██      █ ██ █  █   █  ████ █  █   ██  ███████ █  █ █ █ ██               ██████
█ ██ █ █ █ ██  ████ ███  ██   ██  ███ ██   ██  ██   ██   █ █ ███  █  ██        █  ██████ █ ███    ████    █  ██ █████    ██   █  ███     █ █ █           █ █  █  █     ███ █  ███    █ ██      █     ██ █ ███ █ ███  █     ██       █ █ █   ██ ██    ███      █ █  ██ ██    ██ █   ██  █
█    █    ███ ███  █     █  ██  █ ██   █ █ ███ █  ████ ██  █ ██ ███ █ ██    ██   ███ █   ███    ████   █    █ █       ███ █ █ ███ █   █    ██     █ █ █ ██ █████ █  █ ████  ████  ████      █ █   █    █       ██  ████  █ █  █      █ ███    █  █ █    █ █ ██ █     █ █   █ ████    ███
██ █ █      ███ █    █  ███ █ █   █ ██ ██████        █ █ █ █   █ ███    ██     █  █  ██    █ █    █ █  █    ██   ██  █  █  ███ █     ███   █      ██     ██    ██      ██ █ █ █  █ █████████       █     █  ████  █  █     █    █  █  █    █ █ ███ █   █  █    ██   ██ █   ██ █ █ ████ █
█  ██    █     ███  █ ██   █ ██ ███        █ ██   █  ███  █ ███ █ ████ █  ██  █  █   ██  █ █ ███ ██ █ █     █ █  ██ ████  █ ████  █  █ ██ █   █ █ █    █ ██   █████ █   ████ █   █ ██   █     ███ █      ██ ███ █  ████  █ █ ██████ ████ █████  █   ██   █  ██ █ █ ██   █ ███     █    █
████   █ █ █  █  ██  █ █ ██ █  █   ██     █ █   ████  ██ █         █ █████  ████   █  █  █ █    ██ ███  █ █████  █ █  ████  █ █       █   ██  ███████    █   █   █   █ █   ██   ██████ █  █ █  █  ██ █ █ █ ██ █    ██ ██   ███   █  █ ███      █ ████ █ ██ ████  █ █ █     ███  ██     █
█      █      ██ ██ ████    █     █   █    ██  ██        █ █ ██   █ ██ █ █    █   █ █  █ ███ █     █ ██  █    ███ ██ █ ███   █ ███   █ █  ██ █     █    █    ██ ███      █ ███  █ ███   ████ ████████   █     █  █ █     █   █ █ █  ██  ██ █ █ █ ██    ██ ██    █ █   █  ████ █  ███   █
██ █ ██   ██    █  █   █ ██ ██ █ █  ██ ██  ██ █████ ███ █ ██ ███   █ █████ ███     ██ ████ ██   ██  █     ███  ██  █ █ █ █     ██ █████    █  ████████ █   █  █    ██   █ █ █████ █  █ ██    █       █ ██ █  ██    █   █████ ██   ██ █ █ █ █ ██ ██   ████ ████      ██ ███ █  █   █  █ █
█████   ████  ██ ███  █ █ █ ████  █  ██ █   █ █ ██  ██   ██ ██  █  █  █ ██  ████  █      ██    █  ████ █     ████ ████ █  ████  ██     ██       █ █████   ████  █  █ █    █   ███  ██ █ █  ███ ██   █     █      █ █ ██ ██ █  ███ █    █ █  █ █     ██ █ ██ █  ██ ██  █  █  ██  ███ █ ██
███    ███ ██  █ █ ██ ██ █ █ ████ ████     █  ██ █  ██ ██        ██ ██    ██ █ ██   █  ███   █  █ █ █ ██ █      ██ ███      ██      █  █    █   ████ ██  █   █ █  █ ██     █ █ █ █     ██      ██ ███ █ ███   █ █ ██    ███ ██ █  ████  ██ ██ ██████  █     ██ █  █   ███     █ ██   █ █
███     █  ███  █ █ ██  ██   ████ █  █   █    █████████   █ █ ██    ██     ████  █  █ ██   █   ████ █       █ █  █   ██    █   ██ █    ██ █ █  █ ███       █ █ ██████████    █   ██    ████ ██ ██  ██ █ ████ █ █ █ ███ █   ██             █ █ ███ ██ █   ██  █ █ ██ █ █   ███     █  ███
███ ██    ██  ██  ████  █ █  ██     █ ████ █ █  █    █     ██ █  ███ █ █  ██  ██ ███ █████   ██ ███   ██     ███  ██████ █    ███   █    █     █   ██   █   █ ██   █ █  █       █ ██ █  █    █ █   █ █     █ ██ █ █    ██ █  █ ███  █ ██ ████ ███ █████ ███  █     ███    █   ██   █   █
█   ███  ██    █   █   ███    ██ ██ █    █ ████ ██ █  █   █ ██    ██ █  █ ████ █  ████    ███    ██████      █  █  █  █ █  █  █ ██ █ █ ████    █ █ ███ ██ █ ███     ██   ██  █ █ █ ██     █ █  ███  ████   █ █  █ ██     █   █         █     █████  █ ██  ██  ██ ███ ███ █  █ ██      ██
██   █ ███      ██      █ █        ██  █   █ █ ██ ██ ██  █ █ ██  █  █   █ █  █  █████ █  █ █  █ ██   ████ █ █ █    █  █ ██ █   ████ █  ███  █ █    █   ████ ██ ██ ███        █ █  ██ █ █ █ █ █        █   ███ █ █   ██ ██  █  ███  █  █      ██████      █  █ █ ███    █ ██  █ █ ███  ██
████  █ █ █  ███ ███  ██ █            █   █ ██ █ ████ █    █   █       █  ██ █ █  █ ██ █  █  █ █   ██   █  ██   ██ █ ███      █████    █ █  █ ███   ██ ██     █ █   █ ███ █   █          ██  █  █  █      ██    █ ██ ██  █ ██    ████ █   █   ██ ██    ██ █ █ █   █ ██  ██ ███ █  █   ██
█             ███ ██    █ ██  █   █ ███ █ █ █ ██   ██   █      █ ██ ██      █ █    █    ███████ █  █  ███ ██ █ █ █ █  ████   ████ ██  █ ███        ███ █ ███     █ █  ██   █ ███     █ █ ███ ███ ██ ███ ██     █  █     █   ██ █  ██ ██ ███  █  ██    █    █  █ █ ██   █  ██    █ ██  ██
██  █   ██ ██   █  █  ███  █ ██     █ ████ ███     █ █  █ ████   █ ██  █       █ █                 █ █ █ █  █  █   █ ██  █  █   ██  ██    █  ██ █  █   ██ ██  ████  █    █  ███ ██  █    █   ███     ██     ██ ███  ██ ██    █  █   █  █  █ ████   █  █       █ ██    ███   █    █ █ ███
██ ███  █   ██     █  █  █ █       █████ ███ █ █ █████ █  █ ██  █ █  █  ███  █ ██    █  ██   █ ██████   ██  ██  ██ █     ██ █ █   ██  █  █ ██ █ ██ █   █  █ ███ █ ██  ██ █   █       ██  ███████    ███      █   ██  █  █ ██ ██      ██ █ █ █ █   █ ███   █   █ █   ████  █████   ████ █
█ ██ ████   ██      ███   ███     █       ██   █████ █    █       ███ ██ ██ █████ █  ███ █████   █   ██    ██ ████   █ ███ █ █ █   █   ██  ██ ███ ██ ██  █  ████      █ █   ██ ██    ██  ██ █  █  ███ █ ██  █ █ ██████   █ █ █     █  ███  █ █   █ █     ██   █    █  ██ █  ██████   █ █
██ █ █  ████ ██   █ █ ██      █       ██  █   █ █ ███ ███     ███    ███      ██ ████████ ██ ██    ██ █ █   ██   █  █ █  █  █         █  ███ ███   █   ██ ██   █   ██ █ ██  █   █    █ █ █ █    █ ██ ██ █ ██   ███ █ █  █ ███  ███  █ █     █ ██ █ █ ██ █ █ ██      █  █ █   █  ██ ██  █
██    ██   █    ███        █  ███     ███ █  █    █ ██ █ █ █       █  ██ ██ ██    ██ █  █  █     ██ ████      █ ████      █  ███ █ ██ █  █ █  ██  ███   █ ██   █ █ █  ███ █  █ █ █ █ █  ██ ████  █ █ █   █ █ ██   ██   █     ██  █    █ ███ ██ ██    █  ███ ██  █  ████ █ █ █ █  █ ███ █
█   █    ██ ██   █ █  ██ ███  █  █     ███  █  ██ █  ██ ██    █      ███     ██    ██ ██ █ ██    ████      █   █   █  █  █  ████  █   ███     █ ██  █ █  ██  █████   █ ██     █   ██ █       █  █ ██     █ █    █   █   █ █  █   █ █ ██ ████      ██ ████     █ ███ █  █  ██  █ █ █ █  █
██ █  █  █ █      ██ █ █   ████ █ █ █ █ ███ ██    ████ ██ ██  ███    █   ██ ██ █   ████  ██  █  █ ██   █    █   █  ██ ██       █ █████ ███   ██ ██ ██        █ █  ██  ██ ███      ██ █  █ ██  █  ███ █   ██   ██ ██  █  █        █ ███   ██ █ █ █ ███ █ █   █    █     ██  ██ █ █ █ ████
████████████████████████████████████████████████████████████████████████████████████████████████████████████████████████████████████████████████████████████████████████████████████████████████████████████████████████████████████████████████████████████████████████████████████████
