████████████████████████████████████████████████████████████████████████████████████████████████████████████████████████████████████████████████████████████████████████████████████████████████████████████████████████████████████████████████████████████████████████████████████████
█  █ █  ██ █ ██ █ ██    █ ███   █ █     █ █████ ██  ██ █ █ ██      █     █      █ ███  ██████████    ██   ███  █  ████ ████ ██    ██   █   █████     █           ██ ████  █ █  █  █  ████ ██ █  █  █  █    █  █ ███ █  ██ ███      ██        █ ██ ██ █ ██  ██ ██ █ █  ██  ██ █ ███ █   █
█ █  ██ █████   ██ █ █ █ ██ ██████    ███   █ █  ██  ██      ██ █  ███  █      █      █  █ ████████  ██ ██       █  █ ██ █     █      ██  █  ███ █ ████████ ███    █   █  █ ██ █ ██   █  █  █ █ ██    █████   █████  █    ██ ██  ██ █  █    █      █   ████ ██   █  █ ███ █████  █████ █
█  █ █   ███       █ ████   ████  ██ █  ██ ████ █  ██     ███ █    ███   █    █ ████ █  █  ███ ██ ██   ██   █  █ ███ ██  ███ █ █ █    ███ █████    ██ ██ █       ██    █  ██ █  ██    ████ ███        █ █ █ █ ██     █ ██ █     ██   █ █  ███  █   ███████    ██████    ██   ███  █  ███
████ ██ █ █  █  ███ ██  █ ██ ██ █ ██   ██ ███ ██ ██  ██ █ █  █  █ █ █   ██ █   ██   █   █ ██  ██  █ ██ █  █ ██  ██   █   ███ █ █  ██     ██     █████ ██ █      ███ ███████       █    ███ ███  █████  █ ██  ███ ███ █ █    █ ██     ██ █ █     █ ███    ███  █  █   ██   █████  ██  █ █
█           █  █ █ ██ █    ██  █ █   ██  █  █ █  ██   ████ █████ ███      ██ ██ █ ██  ██ ██   █ ███  █  █   █   ██   █  ██ █  █ █  ██   █ █████ ███ ██  ██  █  █  ██   ██ █  █  █ █ █  █ ██ █ █    █████   ██  ██ ████       ███ █      █  ██   ███ ███ █    █  █ █ ██    █  █    █  ███
█ ██  █ █ ██  ███   █ ██████  █  █ █       █   █     █    █ ██  █   █  █ █   █ █ █  █    ██    ██ ███ █ █████  █ █         ██ ██  ██ ██   █ █ ███  █ █ ██ █ ██████  █ █     █  █  ███ ████ ██  ████  ██ ███  █ █      █     ██   █   █       ████   █        ███ █  █ ██ ███ ██  ██    █
█    █ █ ██         █ ██ █  █ █   ███ █████  █  █  ██ █     █    ██   █ ██  ██ ██      █████     ██ █    █  ██ █ █ █ █ ██ ███ █  █ ███ ██   █    █ ██    █  ████ ██   █  ████  █ █ █ █    █    ███     █   ███ █   ██ ██   █ █ █  ██ █ █   █   █   █    █  █  █   ███ █  ██   █      ███
█ █  ██   █████ █    █ █  ██ █  ████  █      █   █             █  █  █ ██        █ ███ █   █   █████ ██    █    ████ ██ ██    ████  ██   █   ██████ ███ █  █   █ █  █ ███   █  █ ██ █ ███ █     ███ ██   █  █  █  ██   █ █    █  █   █  ███ █ █   ████ ██ █     █  ██ █  ███   █  ██████
█    ██ █ ██  █  █    █  █      ███ █ █ █ ██ ██ ██ ████   █ █ █   █ █ █  ████  ██ █ ████  ██   █  ███   █ █  █████   █    █ ██ █   █ ███  ███  ████ █   ██     █   ██  █ ███   ██ █ █ ████ █ █ █     █  █ █ ███  █████  █ █      █  ██ █     ████ ██ █  ████ █  █  ████    ██  █ █    ██
█ █     █  ███ █ ██████ █  ██ █ ██ █ ███ ██   ██   ██  ██ ██ ███ █ ████  █  ████  █   █ █     █   █ ████ ██  █ █ ██ █  ██    █   ███ █   ███  ████ █   █   ██   ██ ██  █ ████ █  ██         ██  ██ ██   █ ██  ██ █   █  ███ ██ ██  ██ █  █  █ ███  █    ██  █  █ ████  █  █ █  ████   ██
█ ██████████  ███ █ █   ███████ ███      ███ █ ██ ██  ██ █    █ █  █ ███ █    █ █  █  ██ █ ██  ███  ████  ███   █ ████          ██   ██  █  █ ██████ █  █  ██  █      ██ ███  ███ █  █ ██ ██  █  █   █  █ █ █ █  ████  █ █    █ █  █ █ ██ █     █████ █  ██  █  ██  ██ █  █  █  ██ █   █
██  ██   █    ███ ██  █  ██   █   ███  ████   █ █    ███     █ █ ██ █  █ █ █ █ ███ ██  ████ █  ██  █           █  ██ █ ██████ █  █ █   ██ ██ ██  █████   █ █ ███  ██   ██   █ █ ██ ██ ██ █  ██     █ ██ █ █    █ █ █    █  █ ██  ██  ███ █ ██   ███ █ █ ███ █ ███ ███   █ ██  █ █  █   █
█    ████  ████  █  ██   █   █ ██     █  ██   █  █ ██ █ ████  █ █ ██        ███  █     █ ███   █    █ ███ █  █  █     ███  ███   ██     █ ████  █ █  ██  ████████  █ █  ███ █    █  █ ████   ███   ██ █ ██        █ ██      █ ██  █    █       █████ █      █  ██  █ ██   ████  █  █  ██
██    █  █ ███  ████ █   ███████  █  █    ██ █    ██    █ █      █  █    ███ ██████   █  █ ███   ██ ██ █ █  ████ ███  █     █   ███   █  █  █████  ████     ████   █  ██ ████  █  █    █            ██████ ██    ███ █   █ █ ██  ███       ██   █  ███ ███ ██ ███  ███    ██   ████    █
███  ███      ███ ██ ██   █ █   █  █  █ █   █ ██   █  █   ██    █  █  █    ██ ███████   ████ ████     ████   ████ █ █  ███  █ █     ███  ███   ███  ██  █ ██ █    █   █  ██████ █ █  █ █  █  █ █ ██    ██ █ ██ ██████ █ █    █ █   █████ ██ █  █ ██  ██  █   ██ █  ████  █   █  █████  █
█  ██ █ █ █    ███ ███ ███    ████  ██ █  ███    ██   █████ ██    █ █ █ ████     █ ██ █ ██ ██ █ ██ █  █  █ █   █████  █ █    █  ██ ███ ██ ██ ████  ██    █ █ █ ██ ██ █ █ █   ██  █  ██ █████    ██ █  █ ███ ████  █  █  ███ ██ ██    █   █ ██     █ █ ██    █ █ ██ █   ███   █  █ █   ██
████   ██    ██  █    █  █    ██   ██ █ █ █  ██ ████████ ██   █ ██  █   ██ █ █ █ ██ █    █    █  ███  █    █  ██████ ██  ██████   ███  ██    █ █  ███████ ██ █  █████ █ █ ██        ██ ███ █ ██   █    █ ███ ██    ████     █ █ ███    ██  ██ ██  █ █ ██ █  █████  █ ██    █ ███  █   ██
█    ███ █ ██ ██    █    █ ██   ██ ████████   █ █ █  ██ █ █    ███  ██ ██████  ███  █   ██ █ ██ █████  █   █ ██       █        █ █ █ ████  █    █  █      █  ██ ███ ███  ██████  ██  ██████   ███  █   █████    █ █      █ ██ █  ██   ██    ██ ████  ███  ██       ██  ███  ███ █ █    █
██ █ █   ██         █ █ █ ██   █ █ █    █ █████ ███  █  ███ █ █   ██ ██ ████████ █                █ █ ███    ███  █   █████   ███  ██ █  █ █   █ ██  █  █  █    █      █   █   █   █  ██        ██  █  █    ██  █   █ █ █ ███████ █   ██    █ █████   █ ██ █ ██ ██ ██ █  █   █ █    ████
█ ██ ████ █████ ███  █████    ███ █   █  ██ █ ██     ██  █       █     █    █      █████    ███       ██  █████ ██ ██ ███ ████ ██  █ █████ ████  █     █      ██     ██  ██   ██    █     ██  █ ███████    ██     █  ██   ███  █  █ ██ ███ █ ███  █  █  ███ ██ █████  ██ █ █      ██████
█    ███  ███  █     █   ████  █    █ ███ ██   ███   ██  █   █       ███   █    █      █ ██ █ █ ██  █  █      ██ █  ██ █     █   █ █       █ ██ ███ █  █ ██  █  ██ █ ███    ███   ██ █  ██     ██ ████  ██ █ ██  █     █  █  ████ ███ █ █  █ █ █ █  ██ █  █ ██ █ █████  ██        █  █ █
███       ██ ██   ███████ █ ███   ██         █   █  █  █████   █ ██ ██ █ █ ██ █  █ ███    █ █ █           █  █  █ █ █ █ ███      ██  █ ██ ██ █    █ ███    █ █ █  █  █ ██      █    █   █ █ █     █    ██ ██ ███  █         █ █  ██  ██ █ █ █ ██ ██  █ ███     █    █ █ ███     ██   █ █
██  █████     ██ █ █  █ ███    █ ██    █   █  █    █  █     ██   █  █ █ ██ █ ██ █      █  █  █   ██    ██   █   █   █  █ ██   ███████████████  ███   ██ ███ ██ ████  █    █      ██████   █  █ ██    ██    █  █  ██    █    █  █ █  █ █     █   ██ ███  █ ██ █   █████ ██   ████   ██  █
██        █  ██ █   ██ █  ██   ██ █  ██ ████ █████ ██████ █  ███    ███   █      ██  ██    █ ██   █ █    █ █ ███       ████████  ███     ████  █  █  █   ██  █████     █   ██ ██ ███ ██  █       ██  ██ ██   █ █     ██  █  █  ███  ██  █ ██ █     ██    █ █ █  ██  ████████  ██ █  ████
█████ █    ████ ██     ███ █  █ █ ██ ██  █  ███    █  █ █ █ ██  ██ █  █ ██   █  ██ █ █ █      ██ ██ ██  ████   █ █  █ █ █ ██ ████ ███ ██  █    ██  ██ █ ████   ██  ██ █     ███   █  █ █  █   █   █ █   █  ████     █    █ █  ██  █   ██     ███ █ █ █     █  █ █  █  ███  ██  ██ ██  ██
███  ██     █ █    ██ █  █ █ █   ██ ██  ██ █ ██ ██   █      ██ █ ██ █ █  █   ████  ██  █   █ █   █ ██  ██ ██ ██     ██ █ ███ ██ █ █  █   █ █  █  ██  ██ █  █ ██   █  █ ██  ███        █  █████  █ █  ██████████ █   █  ██ █           ██  ██ ██  █ █ ██ █ ███  █ █ ██████████    ██  █ █
███  ███  █   █ ██ ███  ██  █     █   ██ █ ██ █   ██    ██ █  █    ██ ██    █  █    █  ████ ██    █████  █   █ █  █ ██   ██  █ ██  ███ █  █ ████ █   ██ ██    ████ ██ ██   █    ██     █   █████ ██  ██ █    █ ██ ███  █ █ █ █   █ ██ █ █ █ ██   ██  ███    █  ███   ██  ████ ████  █ ██
████ █  █  █ █ █ ████     █  █ ██   █  ██ █ ████ █ █  █  ██  █ ██ ██    █  █ █       ████ ██  █ ███ ██ ██   █ █   █ ██ █ ██        ██   ██ ██     █    ███ █   █ ██████████ █   █ █ █ █ █ ██   █ █      ██ █  █ ██████    ███   ███       ███ █     ███ █ █    █    ███   █ █ █  █  █  █
█ █     █  ██   ██ █ ████████     █ ███  ██ ██ ██ █       ███      █         █ █  █ █ ██   ███    █   █    ██ █  █ ██    █  █   █  █ ████   █  █  █    █ ███  █    █     ██  █  ███  ███ █ █ █ █████   █       ████   ██ ██ █      █ █    █  ███   ██     █ ██  █   █ █ ████  █ █ ██ █ █
█ ██      ██ █  ██    █ █ █    ███  █  ███ █ ███  ███  ███ █  █ █  ██  █ █ █ ██ █ █████   ███ ███ ████ █     ███   ███   ███ ██ █ ██ ██ ██     ██ █ █  ███  █   █ █   ██  ██  ██    █  ████   █      █  █ █ █   ██ █ ██   ████ █    █    █   █████ ███  ██    █  ███████    ███ ███ █ ██
█      █ █ █ █ ██ ██ ██ ██████  █    ██ █  ███   █ █        █ ███ █████       █ ███ ██ █  █ ██ ██  ██    ██  █     ███  ████  █    █ ███  █ █    ███  █       █     ██ ██  █ ███ █ █  █ █    ████ █       ███  ██ █ ███ █  ██ ██  ██    █  █ █   █  █   █ ███████  █ █  █ ███  █  ██ █ █
█  ███ █  ███ ██  █  █  █  ███       █ ██ █ █  █   ██    █   █  █  █ █ ██      ███  ██  █ ███  █   █ ██ █   █  █ █████ █    ████  █  █  █  ███  █ ███ █ █     ██      █   ███   ████████   █   ██  █   █ █     █   █ █   ██  █████ █ █ █  ██   █ █ ███  ████    ██   █ █  ██  █     ████
██████ █  █ ██ ███ █  █ ███ ███  ██  █   █  █  █ ███ ██  ███    █   ██ ██ ████ ██ █   ██ ███  ██ █ █  █         ██ ██    ██    █   ███     ███ █  █   █ █ █  ████    █ ██    ██ ██  ██ █    █ ████ ██ ██ █   ██ █ ███   ███  █ █ █  ██  ███ █    █  █   █   █████     ██ █  ██     █ ███
█ █  █      █   █  █ ███  █ ██  █ ███   █████ ██   █  █  █ █        █    █ █ █ ████ █ █ █ █ ███ █    █     █████  ██████  █   ███ █  ███ ████ █   █ ██    █ ███ █  █ ███ ██    ███ █████   ██    █ █   ██ █ ██   ██      ██ █    █       ███ █ ███ ██  █     ██████ ██ ███ █  ███ ██ █ █
██  █ █     ████  █ █ ██  █ ██ █   █ ████  ██ ██ ███    █ █   █████  █ ████ █  █    █   █    ███ █  █  █ █  █   █ ██ █ █  █     ██   █     ████   █  ███ █    █      ██     ████   ██ ██   ██    ██    ███  ██ ██ ██  █ █ ███  ████ ███   ██  ██ █   ████  █    █    █  ██ ██ ██████  ██
███ █ █ █     █ █ █ █ █  █ █ ███ ██ █   █ █ ██ ██ ███  ███  █  ██ ██ █   ██ ███ ███ █ █  █    ██    █ █  █ ███ █    ██  ██     ███  █ █   █   ██     █           ██ ███    █  █     █ █ █ █ █      ██  █  ███ █   ██ ███ ██  █ █ ████           █ ████    ███ ██     ██ ████ ██ ███  █ █
██   █   █ ██ ██   █    ███ ██   ███ ██    ██ ███ █  ████  █ ██ ████  █  █    █ █ █ █ █ ██ ██  ██  ████  █      ███ █       █   ██    █   █ ██ █ ██ █ ██ █     █ █  █   █  ██      ██ ███  █       ██  █ ███ ███ █ █ ███ ██     █      █   █ ██  █   █  █  ██   █     ████   ████  █ ███
█   █     █ ██ █████ █  ███  █ █ ██      ███  █ █ █ █ █  ██  ██   ██  █  ██ ██ ██  ██   ██  █   ██ █     █     █████    ████ █  █ █      █   ██   █  ██ ███ ██████████ █ ███     ███    █ █████   █ █    █   █   █ █ █ ███    █ █ ██   █ ████ █ ██    █   █ █ ███████████  ███ ██  █ █ █
█  ████ ███  ███   █  █ ██ ██ █ █  ██ █   ██    ███    █  █  █   ██ ██ █  █ █  █ █   ██         █ █ █ ███   ██   █       ██ ███   █ █       ████        █ █ █ ████ ██  █ █   ████     ██   █   █  █     █  ███  ██ ██  █   █ ██ ██     █   ██     █     ██  █  █ ████   █      █    ████
█    ██ █  █   ██    ██   █ █ ██   ███ ███ █  █ █████  ████ █  █ █ ███ ██  █   █  █  █ █  ████   ██ ██   █ ██   █ ███    ████████ ██ █ █           ███ ██ ██  ███     ██  ███  ██  ██   █  ████   █ █    █████  █ █   █      █ ██ █       ██   █  █   █  █ █ ██     ██ █ █   ██   ██  ██
█        █ ██ ███   █  █   ███    █  ██ █        █ █    ██     █ ███   ███ ███ █ ███ ██ █  █  █  ██ █  █    ██     ██ ██   ██  ████    ███  ███ █ ███        █  ██     ███ █  ██    █ █ ██   █   ██  █ ██        ██      ██ █████ █  █   █  █████    ████  █  ████ ███   █  █ █████  █ █
██   █  █ █ ██  ██          ██   █ █   ██    ██  █ █  █  █  █ █   █ █     ████   ██ ██  █   █   █ ██ █      ██ █    █   █  ██  █ █  █ █ █ █ █   ██   █  █  ██ █ ██ ███   ████ ██ ███ █    █ █  ██      █   █ █████ █ ███  ████ █ ██   █  ███  █  █ ███     ████ ██ █ █   █████ █ ██  █ █
█ █    ███     █   █ █  ██  █ █ ████ █      █ █ █ █████ ███  █ ██ █   █    █████████     █ ██  █     █  █  ██ █ ██  █ █  █  ███    ██ ██      █  ██ ███    █       ███ █ █      ███  ██ ███ ██ ██  ████       █      █ █ █     █   ███  █   ██ █ ██  █ ██     █ █  ███ █      █        █
█   ████   ██ █    █  █ ██  ██    ████  █ ██  █ ██   ███ ██ ██  ██ ███  █   ██  █ █ ████     █  █     ██ █ ██   ███  █   █   ██  █ █ ████ ███ ██  █     ██  ██      ██ █   ██     ██ █ ██     ██ █ █ ██ █ █████ █ █   █  █        █ ██   █ █ ███  ██   ██ ███    ██  █  ███ █ █     ██ █
████ ███ ██      ████ █ █    █ █████  █ ████ ███  █ █ █   ██████  █  ██    █ █   ██ █   ███ █ █ ██ ██ ████ ███ ██████ ██ █   █ █  █ █ ████  ██  ██     ██████      █ ███   ███ ████    █    ██ ███ █ █ ██      █  █ ██  █████      █  ██   ██     █    █ █ █   █████   █  █ █    █   █ █
█ █    █   ██    ██    ██      █ ██ █   █  ██████  █  █ ██ █ ██ █ ███ ███  █ ██ ██   ██    █ ██ █  █  ██  █     █   █  ██  █    █  █ ███   █████    █  ██ █ █      ████ █ █ █   ███  █      █  █  █    █  ██  ██████         █ ██   ███  ██ █   █ ██  █    █  ████ █ █  ███████ ███ █ ██
███    ██ ██ ███   █ █   █    █  █ ██ ██  ██    █  ███  ██   ██    ██ █   ██     █ ██  █ █  █       █ ██       █   ██  ███  █      █  █ █ █ ███   ██  █ ██  █   ████   ██    ██ █ ████   █ ████    █ ███ ██ █  █ ███ ███ ██ █   █ █ ████ █ ██ ██  ██  █ ██  █ █    █ █   ██ █       ████
█    ███        █  ███  █ ███  █ ██  █  ███████ ██  ██     █ █ █ █    █ ██   █  ██ █ ██  █ ██ █     █ ██   ███  ███ █  █   █    ██ █  █     █    █ █       █   █ █    █   ███ █  █ ██ █    ███    █ █   █ ███  █   ██  █ █████ ██ █ ██  █ ██   █ █  █████  █ █ ██ █  █   ██  █ ██  █  ██
██  ███  ███  ██  █ █  █  █ ██████ ██  █ ███  ███    █    █ █ ██  ██ █    █ ███ █ ██  █     █ █    █     ███  █    █ ██   █ █      ██████  █ █   ██  █ ██  █  █ █ ████ █  ███     ██   ████     █    █   ██  ███ ██ █ ████ █  █     █ ███     ███ █   ██  ██ █ █  █  ████  █ █   ██    █
████  █ █ █  █ █ ██  █ █ █ ██     █ ██     █ █  █ ██  ██  ██    ███  ██  ██ █ █  █   ██ █    █   █ ███ █ ██ █  █     █    █     █  █ █   █ ██████   █   ██ █  ██  █  ██   ██ █  █████ █    █ ███       █  █   ███ ████ █████   █ █   █ █ █ ██  █  █    █     ██ █     ██     █ ██   ████
█  █  █         ████ ██   █ █████    █   █  █ █   █ █ █ █ █ █ ███ ████   ███  █   █ ██ █ █ ████       ██    █   ████ █  ███  ████  █ █   ████████ ██ █ █ █████ █  █   ██ █    █  ██   █ █ █  ████ █ █ ██ █  █ ██ ██    ███  ██  ███ ██  █       █ ████ ██  ████  █  ██ ████   ████   █ █
██ █     █  █  ██   ██ ███       ██  ███   █ █    ███ ██ ██ █   █ ███ █  █     ██ █  ██  ███ █  █  ████ ██ █ █ █    ████ █   █████ ██  ██ ███  ███     █ █ █    ███  █  ██   █ ██  ██ █████ ██ ███ ████      █     █  █  ██ ██    █  █    █    ███ █  ███     █  █ █   █    █ ███  ██  █
█    ██ █████   ██ █ █       ██    █ ██   █  █   █    ██ ████ ██ ██ █  ███ ██  ██  █ █ ██  █ ██ ███   ██  █  █        ██  ████  █  █     ███  █  ██ ███████   ██ █ █      █      █  ██  ███    █     █     █  ███ █  █    █ █   ██ █ ███ █████  █ █  ███ █ █  █  █  ███   █ █   █ ███  █
█ ███    ██  █  █  █ ██ █ █ █ █  █ ███ █ █    █  ███   ██   █ █ █  ███      ███ ██ █ █   █   █  ████  ██      █  ██ ██    ██  █  █  █ █  ████   ███    █   ██    ██  ██   █  ██  ██    █   ██ ██ █  ██ █ █  █  ████ █   █  ██  █ █   █    █ █ ██ █  █ ██ █ █ █  █ █     ██ █ ███ █ ███ █
█████ █   █   ██   ██ █ █  ███ █     █  █   █ █  █  █  █ ██  ███  █ ███  █   █ █    █ █ ██  ██  █ █ █        █ █  ██   ███ ██      ███ ███    ██   █   █ █   ████ █   █ █ █ █    ████  ███ █     █  █ █   █    ███      █    █ █   █  ██ █  ██ █  ██ ████ ████  ██ ██ █ █    ███    █  █
██  █  ██ ████   █  ███     █ █ ███ █ ███ ██  █ ███ █ █     █   █   █ █     ████  █      █████    █  ████ ███ ██ ████       ██ █  █ ███ █ ██  ██ ██ ██     █   ██ █     █     █    ██   █ ███  ██   █ ██  ██ █ █ █ ██ ██  █  █ ██ ██ █ █  █ ███ █ ███ ██ ███  █  █  █    ██  ███  █ ██ █
██ ██   ████  █ █  █    █  ███  ██  ██   ██  █    █     █ █  █ ████ █ ██████ █ █  █    ███   █   █ ██ ████    █  █      █████   █  ███      █ ███  ██ █        █ ██  ██  ███ █ ████  █ █  ████    █ ██ ██  ███ ███  ██ ██ █  █   ███ █  █  ██    ███  █ ██   █████      █   █  █ █   ███
████ █  █ █ ███     █     ██ █  █ █     ██ █ ███    █   █ █  ███ █ ██   ███  ███ █ ██   █ █   ████ █  █     ██   █  █    █ ██ █  ██  █  █ █  █        █ █   █ █     █   █     █  █  ███ █  █     █ ███  █ ███  █      ███  █      ██ ██ ███            ██   █  █    █   ██   █ █     ███
██  █    ███  ███ ██   ██ ████  █   █  █ █ █   ██ █ ████   ███████ █ █  █ █ █████   █ █  █ █ ██ █ █ ██ █ ███  ████  █  █ █  ██   █  ██ █  █       █ █  ████    █ ███ ██████  ██████ ████ ██   ██  ██████    █ ██    █ ██  ██   ██   █ █     █      ██  ███  █  █  ████  ██  ██  █    ███
█  █ █ ███  █ █  ██  ██ ██ ███   █ █    ██ ██ █  ██████ ██  ██  ██   █  ███  █    ██ █      █ ██ █  ██  █ █    ██  █ ████        █ █ ████ █ ████   █ ███   █  █████   █  ██  █ █ █   █  █ █  █  ███ █  █  █   █ █ ████████ ███  ██   ██ ██ █ ██ █   █  █ █  ██ █  █ █   █ ████  ███ ██ █
█  █  █     █ ███ █   ████   █  █ ██ ██   ███ ██  ██ ██ ██  ██   █   ██     █ █ █ ██  ██  ███ █   ██ █████ ██  █ █  █        ██ █ █  █  █   ███ ██ █ █ █ █  ███   █   █ ██   █ █ █ █████  █ █ █  █ █  ██        █      ███    █████      █████████ █ █  █  █ █    ███   ███ ██         █
█ ██     ██    ██    ███████ █     █  ███    █ █ █████      ██ ██ █    █████     ██ █  █ █████   █    █ █ ████ ██ █       ███  █   ██   █  █ █ █  ██  █ ██  ██   █████ █      █  ███ █  █   ███ █   █   █  ███ █    █████ █ █ █ ██  █      ██      █    █ ███ █   █  █  ████  ███  ███ █
████  █  █  █ ██ ██ ██ ██  ████ █ ██ █ ███  ██   █ █   █ ██   █ █    ██ █        ██    █    █   █ █  █     ████ █  ███████ █ ███ █   ██ ██ █ █  █ █   █   ████  ███  ██  ██ █ █  █     █  █ ██ ██ █  █ ██  ██  █ █  █   █   ██      █ █ ██ ████████   ███ ██ █     █  █   █   ██   █ ███
█  █ ██  ██  █ ██   █ ██ █ ██  ██  ██████  █  █ ████   █████ █ █  ███ █     ██  █ █ █    ██ ██ ███      █  ████ █  ████ █ ██   ██  ███ ██ █ █ ██  █████ █   █ ████   █   █ ██  █ █ █ ███ ██ █  █ █ ██████  ██    █    ██ ███ ██    ███     ███  █   █  ███   █   ██   █  ██ ███ ██  █  █
█  █ █   ██ █ █  ███   ███    ██ ███   █  █    ██   ██ █ ████ ███    ███  ███ ██ █  █ ██  █    █    █ ███████ █  ██ █ █ █ █ █  █        █ █ █ █   █ █    █ ██ █    ██   █ █ █    █████████ ██  ██  ███     ██ ███ █ █   █ ██ █  █    █  ██ █     ██  █  █ █  █    █ █ █     █   ███ █ ██
██  █  █      █     █    █ ██ █  █   █   ██    ██ ██ ██     █     ███ █ █  █  █  ██ ██ █ ██ █      █  ██ █  ███  ██  █   ██  ███     █ █  ███ █ █ █  █ █    █  ██ █ ██ █   █  █ █  █ █  █ ████ █ █        ██     █   █    █████  █ █ █  █ █ █████ █  ██  ██  ██     █   █ ██ ██ █    ███
████████████████████████████████████████████████████████████████████████████████████████████████████████████████████████████████████████████████████████████████████████████████████████████████████████████████████████████████████████████████████████████████████████████████████████
