████████████████████████████████████████████████████████████████████████████████████████████████████████████████████████████████████████████████████████████████████████████████████████████████████████████████████████████████████████████████████████████████████████████████████████
██████████████████████████████████████████████████████████████████████████████████████████████████   ████████████████████  ████████████████████████████████████████████████████████  ██████████    ████████████   ███████████  █████████   █████████████████████████████████████████████
████████  ███████████        █████████   ██████   ███████████████████   ███████  ████████  ██████     ██████████████████    ██████████████████████████████████████████████████████     ███████            ████           ███        ██      █████   ███████████████   ████████████   ███
█████       ████              ██████      ████        ██████████████     ██████   ██████   ███████    ███  ██   ███████     ███████████████████  ███  ████████████████████████          ██████             ███           ███                ████        ██████████     ██████████     ██
█████        ██                ██          ███             █████████     ███████    ████   ███████████           █████        ███████  ███████          █████████████████████            █████       ██    ████         █████               ████           ██████      ██████████     ██
█████                 ██                   ███              █████████    ████████    ███  ████████████            ████          ████       ██            █████████████████                 █████   █████   █████        █████                ██             ████       ███████████    ██
██████              █████                 ███               █████████    █████████  ████ █████████████            █████         ████                      ███████████████                    ███████████    █████       █████                                          █████  ████   ███
██████             ███████               ████              █████████     ██████████████  ██████████████            ████          ████                         ███████████                     █████████      █████      ████                           ████            ████   ████   ███
██████            ████████               ████             ██████████     █████████████    ████████  ███             ██            ███                         ████████████                     ███████        ████     ████                           ██████           ████   ████   ███
██████               ████          ██   ████      ██     ████████████     ███    ████      ██████    █                     ██      ██                         ███████████████   ██              ██             ██     █████                           ██████     ██    ███     ██    ███
███████   ███                     ██████████     ████    ██████████████           ██       ██████              ███        ████                    ██         ████     █████████████                                 ███████                             ████    ████    ██           ███
███████   ███                     ██████████    ████     ███████████████                  ███████              ███       ██████           ██     ███         ███       ████████████     █████            ██        ████████                              ███    █████   ███           ██
██████     █               ██     █████████     ███      ███████████████                 ███████                █        ███████         ████     ██                   ███████████     ███████          ███       ██████████                     ███     ███     ███     █      █      █
█████                     ████    ████████              ███████████████    ███          ██████                              █████        █████                        ████████         ███████          ███      █████   ████                 ███████     █                    ███     █
████                      ████    ████████             ████████████████    ███          ████                                █████         ████                      █████████           █████           ███      ████     ████               ████████                         ████    ██
████                       ████    ██████             █████ ██████████     ██            ██                                 ████           ████                     █████████    ███    █████          ████      ████      ██               ████████                          ████    ██
█████              ███     █████    ████             █████   █████████    ██                               ███              ████            ██                      ████████    ████    ████          █████      ████                       ███ ███                           █████  ███
█████             ████      ████    ███           ███████    ██████████  ███                              ████████           ███                                         ███    ████     ██           █████     ████                       ███                                 █████████
█████            █████      ████     ██          █████      ████████████████               █              █████████          ███                       ███                       ██                   █████    █████                      ████        ████                      ████████
█████            ████       █████    ██          ████     ██████████████████              ███              ███████      ██                            █████                                            ███    ██████                      ████      ███████        ███           ███████
████             ███         █████  ████         ██      ██████████████████               ████                          ███                           █████                                                   ███████          █           ██      █████████      █████           ██████
████  ██          ██         ████████████                █████████████████                █████                         ████                           ███                               ███                  ███████         ███                   █████████     █████            █████
███████████       ██         █████████████                ████    █████            ██    ███████                         ██                                                    ██        ████                  ██              █                      ███████      ███    ██       █████
████████████                  █████████████                        ███           ███████████████     ██        █                                                               █         █████                                                         ██████            ████       ████
████████████            ██         █████████        ███                 ███████████████████████     ████      █████              ██                                                     ████████                                                        ████             ████        ███
███████████             ███         ████████       █████               ████████████████████        ████       ██████           █████                                      █            █████████                                                          █               ██          ██
██████████             ████         █████████      █████               ███████████████████         ███         █████           █████                          ███        ███          ██████████                      ███                                  █        ██                ██
██████████            ████           ████████      █████               ██████████████                            ██            █████          ██        ██████████        ███        ██████                 █████     ███                                 ███      ████               ██
██████████        ███████             ██████       ████████             ██  ████                                        ███     █████        ████      ██████████          █████    ██████                 ███████                     ██                 ███     ████████             █
██████████       ████████              ████       ██████████                                              ████         ████      ████     ████████     ██████████           ████    ████                  ████████                    ████                 █     ██████████            █
██████████       ████████          ██   ██        ██████████                                              █████        ████       ███    ████████     ████████████           ███    ███              ██████████████           ██      ████         ██            █████████             █
█████████        ████████         ████            ██████████                    ███  ███                    ███         ███       ████  ████████      ████  ██████           ███    ███             ████████  █████          ████      ██         ████                                ██
███████          █████████       █████                ███████                  ██████████                               ████       ████████████       ███    ███            ████    ███       █████████████    ████          ██████              ██████                              ███
█████             ██  █████      █████                 ██████                  ██████████                                ██████     ████████████                            ███     ██       █████████████     ████          ███████            ███████                          ███████
████                   ████     █████                  ██████                   ██████████ ███                             █████    ██████████████                          ███              ███████           ████          ████████          ████████                          ███████
███                     ███     ████                   █████                    ███████████████                              ████   ███████████████                                    ██     █████           █████         █████  █          ████████                    █      ███████
███             █       ███     ███                     ████                   ████████████████                               ██████████████████████                                   ██     ████           ██████        █████              ███████                    ███       █████
██             ███      ███    ███                       ████                █████████████████                                 █████████████████████       ██                          ██     ███            ██████       █████              ████████                     █         ████
██    ██       ████    ████    ███                        ███    ██████     █████    ████████   ███                             ███████████████  ██       ████                                                ████   ████████                ████████                               ████
██   ███       ████    █████    ██                        ███   ████████    ████               ████                             ████████  ████            ████                                                ████   ██████                  ████████                               ████
█    ███       ████   ██████    ██                       ████   █████████    ███              █████                            ████████    ████            ██                                                  ███   █████                        ██                ██              ████
█    ██       █████  ███████                            █████    ████████     ███              ████                            ███████     █████                            ██         ████                                          ███                           ███              ████
█   ███     ████████████████          ██      ████      ██████      ████      ████               █                              ███████     ███████                        ██████     ██████                                       █████                 █         ███              ████
█   ███     ████████████████         ███     ██████     ██████                █████                                     ███      ████████    █████████                    ███████      █████                                     ███████                ██        ████             █████
█           ████████████████        ███     ███████      ████                 █████                                    █████          ████   ████  ████              ████████████      █████                                    ███████                           ███              █████
█             █████████████        ████     ███████      ███           ██      ████                                   ████████         █████████    ██              ████████  ██        ███                   ██               █████                ██           ████              █████
█              ███████████        ██████   ███████      ███           ████      ██                               ███  █████████        ████████              ██     ███████                            ██████████               ███                 ██           ████              █████
██             ██████████        █████████████         ███           █████                                      ████   ███████████      ██████              ████     ██                       ██      ███████████                ██                               █████             ████
█████          █████  ███         ██  ██████          ████          █████                                       ████   ████████████                         ███                             █████    ███████████                 ███                                ████      ██     ███
██████         ████    ███              ███           ███           █████           ███              ██          ███   █████████████                       ████                       █     ██████   ███████               ██     ███████                            ████    ████     ██
████████       ████    ████                 ███        █            █████          ████    ███████  ████  ███           ████████████                      ████                       ██     ███████   █████               ████    ████████                    ████    ██     █████    ██
████  ███     █████    ████                ███████                  █████         ██████  ███████████████████             █████████                       █████                       █      ███████ █████         ██     █████  ████████                   ███████         ███████   ██
███    ███    ██████  █████               █████████                  ███         █████████████  █████████████              ███████                        ██████████                          ███████████         ████    ████████████                    ██████████      █████████  ███
██      ██████████████████               ███████████                             ████████████    ███████████               ███████            ██          ███████████    ████                 ███████████     ████████    ███████████            ███     █████████████   █████████   ███
██       ████████████████                ███████████                             ████████████     ██  █████                ███████          ███████        ███████████  ██████               ████████████    ██████████    █████████             ███     ██████████████  ████        ███
██        ███████   ██                   ████████████                   ██████  █████    ████          ████                ██████      ████████████             █████████████                ████████████    ███████████       █████            ████      █████  ██████   ██         ███
██                           ███          ██   ██████                  █████████████      ████         ████               ███████     █████████████              █████████                   █████████████    ███████████      ████       ██    ████       ████   █████               ██
██                           ████               █████                  █████████████       ████        █████             ███████     █████████████                ███████                    ██████████████   ████████████      ██       ████   ████        ███    ███               ███
██                          █████               ████                   ████████████         ████        ████   ████████████████     ██████  ████          ███      ██████     █              ██████████████   ████  ██████               █████   ███        ████                  ██████
██                         ██████                ███         ███████  █████████████         ████         ██   █████████████        ██████                  ███     ███████   ███             █████████  ██    ███    ████                 ████   ███         ███                 ███████
██                        ██████                  █         ██████████████████  ██           ████            ████████████          █████             ██     ███     ██████   ████             █  ████          █                           ████ █████  ██             ██        ████████
█                          ████        ███               ████████████████████                ████           █████   █████         █████             ████     █        ████   █████████            ███                                       █████████████            ████       ████████
█                                     ████           ███████████████████████                 ███          ██████     ████         █████      ██     █████             █████ ███████████           ███                        █████          ████████████             █████       ███████
█                                    █████          ████████████████████████              ████           ███████     █████        █████     ████    █████             █████████████████           ████                      ███████         ███████████            ███████       ███████
██                                  ██████          █████████████████████████      ██    █████          █████████   ███████       █████     ███     █████            ██████████████████           ██████                   ████████          █████████           █████████        ██████
███       ██             ███████   ████████     ██ ███████████████████████████████████  ███████   █████████████████████████      ███████   ████    ███████           ███████████████████         █████████         ███   ███████████  ███    █████████      ██  ███████████       ██████
███████  ████  ███  ████████████████████████████████████████████████████████████████████████████████████████████████████████    ██████████████████████████████████  ██████████████████████████████████████████    ████████████████████████   ██████████   █████████████████████  ███████
████████████████████████████████████████████████████████████████████████████████████████████████████████████████████████████████████████████████████████████████████████████████████████████████████████████████████████████████████████████████████████████████████████████████████████
