████████████████████████████████████████████████████████████████████████████████████████████████████████████████████████████████████████████████████████████████████████████████████████████████████████████████████████████████████████████████████████████████████████████████████████
██████████     ███████████████████████████████   ████████████████████████████████████████████  ███████████████████████████████  ███  ████   ███████████████████   ████████████    ██   ███████  ████████████████████████   █████      ██████████████████████████████████████████████████
█████████       ███████         █████████████     ███ ████████████████████   ███████████████    █████████████████████████             ██     █████████████████     ██████████                    ██████       ███    ██     ███        █████   ████████  █████   ██████████  ███████ ███
█████████        █████           ██  █████             ██████████████         █████ ███████      ████████  █████████                         ████     ████████      █████████                                               ███        ████     ████      ███      ███████    █████   ██
████████████      ████                ███             ███████████████          ███   ██████         ████    ███████                         █████      ████████ ██     ██████                                               ███       █████      ███      ███       █████     ██████ ███
█████████████     █████                █              ███████████████           ███████████          ███    ██████                         ██████        █████ █████   ██████                                               ███       ████       ████               ████       █████████
██████████████    █████                                █████████████            ███████████           █     ██████                         ███████        ███   █████████████                               ██              ████       ██         ███                ██         ████████
███████████████   ████                       ████       ███████████              ██████                    ████████                        ████████       ███   █████████████         ██████                ███             ████                  ███                              █████
███████  ███████ ████            ██        ███████       █████████                ████                    █████████████                    ████████        █    █████████  █         ████████               █████      █     ███          ████   ████                               ████
██████    ██████████            ████      ████████████    ███████                 ███                     ██████████████                   ███████              ████████             ████████               ██████    ███                ███████████                                 ███
█████     █████████             ████     ██████████████   ███████                ████           ████      █████    █████                   ██████               ████                 ████████              ███████   █████              ███████████                     █             ██
████      ███ █████              ███    ███████████████   ███████                ███           ██████      ███      ████                   ██████                ██                     █████              ██████   ██████              ██████████         ██          ██              █
████     ███  █████                    ██  ████████████   ██████                 ███          ███████               ███                     █████                                        ████             ██████   ███████             ███████████        ████        ███              █
████    █████ ████                    ██    ██████████   ███████    ██           ████        ████████               ███                      █████                                        ███             ██████  ████████          █████████  ███        ████      ████               █
███     ██████████                   ███     ███████     ██████    ████          ████      █████████                ███   █                   ████                █                       ███             ███████████████          █████████   ████        ██      █████       █████  ██
███     ███████████                 ████     ██████      █████    █████         █████    ██████████          █       █   ███                   ██                ███                                       ████████████            ████████    ████                ████       ██████████
███     ███████  ██████             █████    ████       ██████    █████         █████   ██████████          ███          ███           ███                       ██                █                  ██    ███████████            ███████    ██████               ███       ███████████
████     █████    ██████            ██████   ███        █████     ████      █   █████   ███████             ████         ███          ██████                            ██        ███                 ██     ██████████            ███████     ██████                    ██████████ ████
████               █████             █████    █          ████      ██      ███   ███     █████               ███         ████          ██████                          ████      ████      ██         ███     ██  ██████           ███████       █████                  ███████████  ███
███                █████               ██                 ██               ███   ██       ████               ███          ████          ███████                       ██████     ████     ███         ███          ████████        ███████          █      █            ███████████ ████
███                 █████                                                  ██   ██         ██                 ██          █████  ██     ████████  ██               ██████████     ██      ███         ████          ████████       ███████                ███           ████████████████
████                ██████                                                ███   ██               ██████                  ██████████     █████████████             ████████████            ███          █████        ████████        █████                ████           ████████████████
█████                █████               █                     ███       ████   ██              ████████                 █    █████     █████████████            ██████████████          ███            █████        ██████          ██                  █████           ███████████████
██████               █████              ███      █     ███    ████      █████   ██              ███████                ███              ██████████████           ████   ███████         ███              ████         ███                                 ███████         ██████████████
██████       ███    ██████             ████     ███    ████  ████       ██████                   █████                 ██               ██████████████           ████   ████████        ██                ████                                ██████         █████         █████████████
███████      ███    ███████            ████    ████    █████ ███        ██████             ██                                          ██████████████            ████    ███████      ██                   ████                              ██████████       ████         █████████████
█████████    ███     ██████           ████    █████    █████             ████             ████               ██                        ███████████               ███       █████     ███               █    ███              ███             ████████████      ██           █████  █████
██████████   ███        ████          ███     █████    █████                              ████              ████          ███          ██████████               ███         █████    ██      ███      ██    ███             █████             ███████████                   ████     ███
█████████     ██         ████          █      █████    ████                                ██               ████          █████         █████████             █████         █████    ██     █████          █████    ██      █████             ████████                      ████      ██
█████                     ███                 █████     ██                                                   ███           █████          ███████         ████████          █████    ██    ███████         ███████████     ██████             ███████                  █    ████      ██
█████                     ███                 ████                                                            █             ███            ███████       ████████            ████    ███  ██████████        ██████████     ██████             ██████                  ███   ████     ███
█████                                        █████                                       ████                                              ████████      ███████               ███  █████████████████       █████████       █████              █████                 ████    ███    ████
██████                                       █████                                      ██████                                            █████████       █████                 █████████████████████       █████████        ████      ██         █                ██████    ███   █████
███████                            █         ████      ███                              ███████                        ███                ████████        ████                  ███████████████████          ████████         ████    ████                         ██████    ███   █████
██████                            ███         █       ██████                            ███████                       ███████              █████          ████                  ████████  ████████            ███████           ██    ███                           █████     █    █████
█████                    ██   ███████                ████████    ██                    ████████                       ████████             ████           ████                   ██████    ███████             █████                                                 ███           █████
████                    ████████████                  ████████  █████                  ███████                   █    ████████              ██        █   ████                    █████    ██████                                              ███                                ██████
███                     ████████                          ██████████████   ███         ███                      ███     ██████                       ██   ████                      ████   ████                                                ███                               ███████
██                      ███████            █               █████ █████████████                                  ███      ████                         █   ████                       ███    ██                                                 ███                               ███████
██                     ███████            ███              ████        ███████                       ███████   ████               ██       █               ██                         █                              ███             ███                                   ███   ███████
██                    █████                █               ███           █████                      █████████  ████   ███         █████   ███                                                                        ███            ██████                               ██████   ██████
██                    ████      ████████                  ███             ████                     ██████████   ███   ███         █████    ███                                                                      █████    █      ███████                             ███████   ██████
██                    ████     ██████████             ███████             ███        ███           █████  ██     █                 ██      ████                               █                                    ██████   ███      ███████       ██                   ████████ ███████
███                   ████     ██████████            ████████    ██       ███       █████                                                  █████        ██            ██      ██                    ██████         █████    ████      █████       ████                  ███ ████████████
███                   █████     ███    █              ███████   ███       ████      █████                                    ██            █████   ██  ████          █████            ████          ███████   ██   █████     ██                   █████                      ███████  ██
███                  ████████                          █████     ██       ████      █████                                   ████   ███     ████   █████████          ██████          ██████         ██████   ███████████                           ██████                     █████    █
███                 ██████████                                            █████      ████                        ████      ████████████     ██    ██████████    ██   ███████         ██████                  ███████████                            ██████                     ██      █
███                ██████   █                                             █████      █████                      █████      ████████████            ███████████████   ███████            ████                 ███████████                              ███                             ██
████                █                                               ██    ████      ███████                    █████        ████████████                   ██████     ██████             ████                ██████████                                                               ██
█████                                                                     ████      ███████                   █████           ██████████                    █████      █████             ████                 ███████                                                                ███
█████                            ████                                      ████     ███████                   ████                   ███                     ███        ████              ██     ██            █████                                                    █           ████
█████                           ██████                       ███            ████    ████████                  ████                    ██       ██             ██                                 ███            ███                                                    ███          ████
██████                           █████                       ███            ████    ████████                   ████      ████         ██       ██             ██                                 ██             ██                                 ███                 ███           ███
█████████                        █████           ███        ███             ████     █  █████                   ████  ████████████    ██        ██           ████                 ██                           ███                                █████                 █            ███
██████████                       █████          █████     █████              ██          ████              █     ██████████████████   ███       ██           █████   ██          ████                           █        ███                    ████████      █                       ██
██████████                      ██████          ██████  ██████      ███                   ██              ███      █████  █████████    ███      ██            ███████████        ████    █                              ████                   █████████     ███████                  ██
███████████                    ████████          ███████████        ███                                   ███       ███   █████████    ████     ██             ██████████       █████   ███          ██                 ███                    ████████       ███████                ███
█████████████                   ██████████        █████████          ██                                    ██             ███████       ███    ████            ██████  ██       █████   ████        ████                ███                    ████████        ████████             ████
███   ███████                        █████          ██████                                             █                   ██           ████  ██████            ████            █████   ████        ████                ██                      ██  ███         ████████           █████
██     ██████                         ████           ████                                       █     ███                               ███████  ███             ██             ████    █████      █████                ██                           ██         ████████    █      █████
██                                                                                             ███    ███             ██                 █████                                   ██      ████     ███████               ███                                    ████████    ████    █████
██                                             █                                   ██          ███     █            █████     ██           ██                                             ███    █████████              ████                                  █████████    █████   █████
███                                                                               ████          ██                 █████     ████                                              ██         ███    ███████████           █████                   ██           ██████████      ████████████
████      █                                                ██████                 ████           ██        ████    ███      ██████         ██                  ██             ████        ███    █████████████  ████  ██████                  █████        ███████████      ████████████
█████    ███                       ████                 ███████████               ████           ██      ███████  ████     ███████        ████                ████   ███      █████       ████  ████████████████████████████                  ██████      ████████████      ████████████
██████  █████    ███   ██   █████████████             ██████████████             ██████         ████   ███████████████    █████████     ███████         ███  ████████████    ███████      ███████████████████████████████████       █████     ███████    ██████████████    █████████████
██████████████████████████████████████████████████████████████████████████████  █████████████████████████████████████████████████████████████████████████████████████████████████████    ███████████████████████████████████████████████████████████████████████████████████████████████
████████████████████████████████████████████████████████████████████████████████████████████████████████████████████████████████████████████████████████████████████████████████████████████████████████████████████████████████████████████████████████████████████████████████████████
