███████████████████████████████████████ ████████████████████████████████████████████████████████████████████████████████████████████████████████████████████████████████████████████████████████████████████████████████████████████████████████████████████████████████████████████████
███████████████████████████████████████  ███████████████████  ██████    ███████████████████████████     █████████████████████████████████████████████████████████████████████████████████████████████████████████        █████████████████████████████████████████████████████████    ██
███████████    ██████████████████  ████     ███████████████    ████         ████     █████   █████       ███  ███████████████████████████████  ██████████████████████    ██   ████  ███    ██     ██████████              ██████  █████   ████████████████     ██████████████          █
██              ████████████         ██        ███████████                  ███       ███     ████                 █████████   █████████████    ████████████████████           ██                     █████               █████    ███     ████████████         █████   ████           █
█                █   ██████                     ████ █████               ██████                ██                   ███████         ████████          █████████████                                    ██                 ████             ███████████                  ████           █
█                    ██████                           ████              ████████                                    ██████           ████████          ███████████                    █                       ██                               ███████                   ████         ██
█                    █████          ██                ████              █████████                                    ████            ████████████       █████████                    ████                     █████                             ██████                    ████       ███
█     ███            █████         ███                 ██               █████████                                                    █████████████         ██████      ███           █████                    ██████                            █████                      ████      ███
█    █████           █████          ██                                   ████████                             ██                 ██████████████████         █████     █████           █████                    █████                            ████            ██         █████    ████
██  ██████           ████                                                ████████                             ███               ██████████████████          █████     █████            ████                     █████      ██               ██████             ████       ██████   █████
██  █████             ██                                                 ████████                 ███         ████              ███████████████             ██████     ███             ████                      █████    ████             ██████             ██████      ██████   █████
██  ████                                                                 ███████                  ████          ███              █████████████     █████   ███████                      ██                        ████    █████            ██████     ██    ████████      ██████      ██
██   ███                    ███                                                                   █████          █                ████████████    ███████████████               ██                                 ██     █████             ████     ████████████████                  █
██   ███      █             ███                                                              █     ████                            ███    ███     ██████████████               ████                                        ████             ███      ████████  ███████                 █
█     █      ██      ██     ██                   ██                               ██        ███     ██                                            ████████████                 ████                       ███           █         ███       ██      ████████    ██████                 █
█                   ████     █                  ███                     █████    ████       ██                    ██                               █████████                █   ███         ███          ████          ███         █       ███    █████████      █████                ██
██                  ███      ██                  █                     ███████  ██████    ███                    ██████                               █████                ███ █████       █████        █████          ████                ███   █████████        ███                 ██
███      ██                  ███                                       ████████████████                          ███████                              █████                █████████        ███         ████            ███                 █    █████            ██                 ███
████████████                ████                                       ███████████████                          ████████                   ███       ███████                ███████         ███        ████              ██                      ████        ██                ███  ████
████████████               █████                               ██       ███████  ██                     ██    ██████████          ██      ██████    █████████                 █████        ███    █████████      ██                             ████        ████               █████████
████████████              █████                                ███        ████                         ████  █████  █████        ████     ███████   ███████████████            █████      ████    ██████████    ████                            ████        ████               █████████
████████████              █████                               █████                                    ████  ████    ██████     ████       ██████   █████ ██████████            █████     ███     ██████████    ████                           █████        ███                 ████████
██████     ██              █████                        ████  ████████                                  ██    ██     ████████  █████         ███    ████   ████████             █████              ████████    ██████                          ████        ████                   ██████
█████      ██               █████                      ███████████████████                     ██                    ████████████████               ████    ██████             ██████               ███████    ██████████████                  ███        █████            ███     █████
████                        █████                      ████████████████████                   ████                   ███  ████████████              █████    █████             █████                 █████          ██████████                ███         ██████          ██████    ████
████                         ████        ██             ███████████████████                   ████       ███████           ████████████       ███    █████    ███              ████                  ████            ██████████              ███           ██████         ███████    ███
███                          ████       ████            ██████████████████    ██████           ██       █████████         █████████████      █████      ████                    ██                    ██               ██  ████               █             ███████        ██████    ███
███                         ██████      ████            ███      ████████     ███████     ██           ███████████       ██████   ██████     ██████      ████                                     ██                       ███                              ████████         ████    ███
██                         ███████       ██            ███        ██████       █████     ████     ████████   ██████████████████    ████████   █  ████    ████                                    ████                      ███                              ████████          ███   ████
█            ██           ████████                    ████         █████        ███     █████    ████████       ███████████████      ███████      ███    ████                                    ████                     ████                      ██       ███████          ██████████
█           ████          ███████                    ████           ████                ████    ████████          █████████████       █████        ██     ██                                     ████                     ████                      ███         ███           ██████████
██         ██████          █████                    ███              ███                 ██     ███████             ██████ █████     ████                                                        ███                      ████                       ███                      ██████████
███        ██████           ████                   ███                █                         █████        █        ███   ████    ████                                       ███              ███                      ██████                       ██                 ██   ██████████
████       ███████           ████     ██          ███                              ███           ███        ████             ██     ████                                      █████       ████████                      ███████                        ██               ████████████████
█████     ████████            ████                ██                               ████           ██        █████                  ████                                    ████████      █████████                      ███████                        ██               ████████████████
██████████████████            ████                ██                                ███           ██        █████                 █████     ████   ████                ███████████      ██████████                       █████                        ███                ███████████████
███████████████              █████         ██     ██                                              ██        █████        ██       ██████   █████  █████               ███████████      ███████████      ██                                            ███                   ████████████
█████████████              ███████        ███                                                     ██         ████        ███     ████████  ████   ███                  █████████     █████████████     ████                                           ███                    █████  ████
████████████              ███████      ██████                                                    ████        ████        █████████████████  ██    ███            ███    █████      ███████████████      ████                                          ██                      ███    ███
██   ██   █               ██████      ███████                   ███                              ████        ████        █████████████████       ████            ████    ██      ████████████████        ███                                          ██                             ███
██                         ████      ████████                   ███████                           ███         ███         ████████████████       █████           █████          ████████  ██████          █                     █                     ██                             ███
██              █                     ██████          ██         ████████                         ███          ██           ██████  █████        ███████          ████         █████████   ██                                  ███      ███                                 ██       ███
██             ███                                   ███          ████████                                     ██            ████     █           ██  ███                     ███████████                    ██                        █████                               ████     ████
██             ██████                            ███████              █████                                   ████            ██                       ███                   ████████████           ███    █████                      ███████                              ████    █████
██              ██████                           █████                 ███                            ██      ████    ███                              ███                  █████   █████          ████   ██████                    ███  ████                 █            ████   ██████
██              ███████                          ████                                                ████     ████    ████                     ████   ████                  █████      █          █████   ██████                    ██    ███                              ████   ██████
██              ███████                          ███                                                 ███      ███     ████    ███             ██████  ████      ███         █████                 █████   ██████                          ███                        █      ██     █████
██        ████████████                           ███                                               ██        ████     ████    ████           ███████   ██      █████         █████                 █████ ████████                         ███            ███         █              ████
██       ██████████                              ███                  █       ██                   ██        ████    █████   █████          ████████           █████          █████████              █████████████            ██           █            ██████                      ████
██      ██████████                               ███                 ███     ████         █                  ████    █████████████         █████████            ███             ████████   █          ██████████████         ████                        ████████                    ███
███  ███████████                                ███                  ████   █████         ██                 ████    ████████             ██████████                             ██████    █          ███████████████        █████                            █████                   ██
███████████████                                ████                   ███    ███          █                 █████    ███████             ███████████                                                  ███████   █████        █████       ███                   █████                   █
██████████████                                █████                    █                            ██   ███████     ███████             ███████ ███       █████        █                            ██████      ███         █████      █████                    ████                  █
█████████████                                 ████          █                                      ████████████      ██████   ███         █████   █     █████████                           ██       █████                  █████       ██████                     ███         ██      █
████████████                                   ██          ███                                     █████████         █████   ████         █████        ███████████                         ████      █████                 █████         ████████                   ███       ████     █
████████████    █                              ██          █████████                               ███  ███          █████   ████        ██████        █████   ███                        █████      █████                 █████          ████████       ███        ███       ████   ███
███    █████   ███                              █          ██████████                                           ███   ███     █          ██████         ███     █           ██             ███       ████                 █████           ████████       ████       ██       █████  ████
██      ████    ████           █         █       █          ██████████                 ██                       ███   ███                ██████         ███            ████████                      ███                ██████             ████          ████      ███      ██████  ████
███      ████   █████         ███       ███      ████        ██████████                 █       █               ███   ██                  ██████  ██     █            ████████                       ███               ██████      ███     ███           ███       ███      ██████   ███
█████     ████   ████        ███        ████      ███            ████████                      ███             ███   ███                   █████████                  ███████                        ███              ██████      █████   ███            ███      ████      ██████    ██
██████     ███    ████      ███      █   █████                      ███████                     █             ████   ███                   █████████                  ██████              ███        ███             ███████       █████████              ██     █████      ███████   ██
██████      █     ████      ███     ███  ██████                      ███████                          ██      ████    ███    ███            ███████                   █████              █████       ████            ████████      ████████               ███   ██████    █████████   ██
█████              ███     █████     ██████████         ████             ███                         ████     ████     ██   █████               ██                    █████              ██████      ████            █████████     ████████                █    ██████   ██████████   ██
█████              ███     ███████   ██████████         █████████         █         ██              ████       ██       █   █████                                      ████             ███████       ██             ██████████   █████████                     ██████   ██████████   ██
████               ████    ████████████████████         ███████████             ███████      ████  █████                █████████                                       ████           ████████                       ██████████████████████                    █████     █████████   ██
████              ██████  ██████████████████████       ███████████████         █████████     ███████████               ██████████                        ██             ████████      ██████████                       ████████████████████████    █████       ██████     ██████████████
█████         ████████████████████████████████████    ███████████████████████████████████   ████████████████  ██      ████████████         ██████████████████████████  ███████████   ████████████      ██        █████   ███████████████████████████████████  ████████   ███████████████
███████████████████████████████████████████████████████████████████████████████████████████████████████████████████████████████████████████████████████████████████████████████████████████████████████████████████████   ██████████████████████████████████████████████████████████████
