████████████████████████████████████████████████████████████████████████████████████████████████████████████████████████████████████████████████████████████████████████████████████████████████████████████████████████████████████████████████████████████████████████████████████████
███████     █████████████████████     ███████████████    ██████████████████████████████████████████████████████████████████████████████████████████████████████    ████████  ██████████    ███████████████████████████████████████████████████████████████████████████████████    ██████
██████           ██████████████        █████  ██           ██    █████   ███████               ██  ██████████         █████        ███████████████ ███              ██████    ███   ██      ██████████████████████████████████   ████        ███████  ██████          █████         ████
█████             ██████████            ██                        ███     ████                      ████████            █           █████████████                     ████                  ████      ███████████████████████                 █████    ████            ███           ███
███               ██████████                                      ██      ███         ███            ███████                         ███    █████                      ████                 ███        ███████████████                         ████     ██                           ███
██                ██████████                         ███         ██      ███         █████            ██████                                  ██               ████     ███                 ███             █████████                           ████                                ████
██                 █████████████                    █████       ███    █████        ██████             ████                                            █      █████                      █  ███               ███  ██                            ██████                             ████
██       ███       ██████████████████            ████████      █████ ███████        ██████     ███                       ████                         ██     █████                      ███                                  ██     █            ████████                           ████
███      ███        █████████████████   ██      ██████████    ███████████████         █████  █████                       █████                               █████                       █                                  ████   ███            █████████                ██████    ███
███       █             █████████████  ████     ██████████   █████████████████         ███████████                       ██████                              ████                                                           ████   ████            █████████              ████████    ██
██                       ████████████  █████   ███████████   ██████████████████         ████████                           ████                               ██                                                            ████   ████                █████              █████████  ███
██                        ███████████   ████  █████  █████    ████    ██  █████    ██      ████                             ███                                           ███                    ███                         ██    ████                 ████              ██    ████████
██                         ██████████   ████  ████    ████     ██          ████   █████     ████                             ██                                          ████████                ███                               █████                 ███                      ██████
███                        █████████████████   ██     ████                 ████   ██████    █████   ███                                  ██        ███                   █████████                                                  ██████     ███                                  ████
█████                     █████████████████          ████████              ████    █████     ██████████                                 ████       ████                   ████████                            █████                  ██████   ████                                   ███
██████                    █████████████████         ██████████             ████     ███      ██████████                                 ████       █████                   ██████                          █████████                    ████  █████                                   ██
███████                    ████████████████        ███████████             ████             ██████████                          ███     ████       █████             ██                                   ████  ████              █      ███  █████                                   ██
█████████                  ████████████████        ███████████             ████            ████   ███                        ██████     ████       █████            ████                                 ████    ██              ███     ███  █████                                   ██
██████████                 ████████████████        ████  ████             █████           █████    █                        ███████     ████       ██████           █████                                ███                    ████      █   █████                                   ██
█████████                 ██████    ██████        ████    ██              █████           █████                            ████████      ███      █████████          █████                              ███                     ███            █████                         ███     ███
███  ████      ███        ██████                 █████                   ██████            ███                             █████████      █       ███████████        █████        ███             ██   ███                      ██              ████                        █████    ███
██    ██    ███████        ██████              ████████              ██████████                                             █████████            ██████████████     █████         ███            █████████      █               ██                                        ████████   ███
██    ██    ████████       ███████            ███████████            ███████████                                            █████████            █████████  ████████████           █              █████████                      ██                                       ████████    ██
██   ███    █████████      ████████           ████   █████           ███████████                                           ██████████           █████████    ██████████                           ██████████                     ███                ███                  █████████    ██
███  ████     ████████     ████████            ██    ██████           ███  ████                                           ████████████         █████          ████████                             █████████              █     █████              █████                ██████████   ███
███   ████     ██████████   ████████    ███           ██████████                                                           █████████████████  ██████           ███████                                  ███         ██   ███    ██████            ██████                ██████  █    ███
███    ███     ███████████   ███████   █████            ████████                                              ██              ██████████████████████            ███████           ████                  ███         ███████      ████            ██████                 █████        ███
███     █       ███████████ ███████   ██████      ██     ██████                                              ███               ██████████████████████            ██████           █████                ████         ███████       ██             ████      █████████     ████        ███
████                ███████████████  ███████      ███    ██████                                               ██               ████████████████  █████           █████            █████                ████        ████████                     ████      ███████████   █████         ██
████                 ██████████████████           ████   ██████                                          ██                   ███████████████     ████            ████             ████                 ██        ██████████          ███       ████     █████████████████████        ██
████                  ████████████████            █████  █████                                          ████                ████████████████      ███             ████             █████                         ███████████          ███       ███     ██████████████████████       ███
███                        ███████████             ████  █████                                          ███████           ████████  ████████     ███       ██    █████             █████         ██              █████   ██          █████      ███     █████████████████████        ███
███                         █████████              ████  ████                                           ████████         ████████    ████████    ███       ██    ████              █████        ████             █████               ██████     ███     █████████████████            ███
███             █          █████████               ████   ██                                             ███████         █████        ████████   ███      ███     ██               █████        █████             ████                ██████   █████    █████       ████              ██
███             █      █████████                    ██              ██      ███                           ██████          ███          ███████   ███      ███                       ███          ████              ██           ██       ███   █████     ███        ████              ██
███        ██         █████████                                    ████    ████            █    ██         ████           ███              ██            ████                                     ███                          ████       █   ██████                ████              ██
███        ██         █████████                                   █████   █████                 ███        ████          ████                            ██████    ██                             ███                          ████           █████                █████              ██
██                     ███████                                   █████    ███        ██         ███        █████       ███████                           ███████  ███                 ██          ███                           ███           ████                █████               ██
██                     ██████                                    ████    ███        ████        ███       ███████     ████████                            ██████   ██        ████    ████                                                      ██          ██     ██                  ██
██                     ██████                                     ██     ██         █████████    █        ███████     ███████                             █████             █████    █████                                                                ████                       ███
██                     ██████                                            ██          █████████             ██████     ████                                 ██               ███      █████                                                                ████          █           ████
███                     █████                                █          ████  ███    █████████             ██████     ███                                                   ██       █████    ████                                                        █████        ███         █████
███       ███            ███                                ███        █████████      ████████              █████     ███                                                   ██       ████    ███████  ██                                                   █████       ███         █████
███      █████                                               █         ████████        ██ ████               ███      ███                      ███                 █       ███       ████   █████████████                     ██           ██████          █████       ████        █████
██       █████                          █                              ███████             ████   ███                 ███                     █████            █  ███     ████       ████  ██████████████                    ████          ███████         ████        █████        ████
█        █████                           ███                             ████              ████  █████                ████                    ████            ███████      ██         ███  █████████████                     ████            ████          ████        █████         ███
█    ██   ███                            ████████                                           ███  ██████              ████████████              ██      ███     ██████                  █   ██████                             ██    ████                    ██          ███          ███
██  ████                                 █████████                                                █████  ███        ██████████████                    █████     █████                       ████             ████                  ██████           ██                               ███
██   ███                                 █████████                                ███              ███  █████       █████████████                     █████      ███                              ██         █████                 ██  ███         ████                              ███
██    ██                                  ███████                                 ████                  █████        ████████████                     ████                                       ████        █████                ██    ███        ████                              ███
██     ██                                   █████                                 █████          ██     ████           ██   █████                      ██                                        █████  ██   ████                ███    ███        ███                   █           ███
██                    █       ██       █     ████               ███  ███             ████        ███    ███                  ████      ███████                                          █████     █████████   ██                 ███                █                   ███          ███
███                  ███      ███     ███    ████              ██████████             ████       ███                         ████     █████████                                 █      ███████     ████████                     ████                              ██    ███          ███
████                         ████     ███     ██               █████  ███              ███       ███                        █████     █████████                     █████      ███      ██████       ██████                      ██                              ███                 ███
████         █             ███████     ██            ██         ███                              ███                        █████     ███ █████                  █████████      ███      █████        ████                                                        █                 ████
███         ███            ████████                 ██████                    █                  ███                        █████          ███                 ███████████       ███     ████          ██                                                                           ████
███                        ████████                 ███████                  █████                          █                ███          ████          ████  ████████████        ███     ██                                               ███                                      ████
███                            ███             █     ██████      ██          █████                         ███                            █████        █████████████              ███                                                     █████                               ███   ████
███                     ██                    ███     ████      ████         █████                         ███                             █████      █████████████               ███                                ████                ██████                      ██       ████   ███
███                    ████                   ███             ██████        █████                          ████                             ████     ██████████████               ███                                █████    ██        ████████                    ████      ████    ██
███                    █████                                  ███████       █████        ███               ████                              ███     ██████    ████          █    ████                               ████    ████████  ██████████                   ███        ██      █
████                    ████          ██            ██        ████████      █████       █████              ████                               ██     █████      ███         ███   ████████             █                     ███████████████  ████                                     █
█████                    ████         ██           ████        ████████      ████       ██████    ████     █████                              ███     ████       ███    ███████████████████           ███                    ██████████████    ████     ███                           ██
██████             ██     █████       ██           ████          ██████████  ████      ███████   ██████    ██████                             ███      ████      ███   ████████████████████           ████                   ████████████      ████    ███████                      ████
███████          █████    ██████      ██           ████           ███████████████      ███████   ██████     █████████    ██    ██            ████      █████    ████   ████████████████████           █████     ███          █████████████    █████   █████████           ██  ██  ██████
█████████     █████████  ███████     ████         █████          █████████████████    █████████ ███████     ██████████  ████  ███████████   █████     ███████████████ █████████████████████          ███████  █████████████████████████████  ████████████████████        ███████████████
███████████  ████████████████████   ██████       ███████   █████████████████████████████████████████████   ███████████████████████████████████████   ██████████████████████████████████████████  █████████████████████████████████████████████████████████████████   ███████████████████
████████████████████████████████████████████████████████████████████████████████████████████████████████████████████████████████████████████████████████████████████████████████████████████████████████████████████████████████████████████████████████████████████████████████████████
