██████████████████████████████████████████████████████████████████████████████████████████████████████████████████████████████████████████████████████
███████████████████████████████████████   ███████████████████████████████████████████   █████    █████████████████████████████████████████████████████
██████████████████████████████████████      ██████████████████████████████████   ███     ███      ██          ███████████████████████   █████   ██████
██  ██████████████████   ████████████        ████████   ████████████  ███████                                  ███████████████  ████     ███      ████
█    ███  ███████████     ███████████           ████     █████████     ██████                                     ███████████    ██                ███
█           █████████     █████   ██             ██          ████       ██████                                     █████████                        ██
██              ██████    ████                                ███         █████                                    ███████                          ██
██               ██████    ██                                 ███          █████                                    ██                              ██
██                █████                                        ███          ████                ██                                                 ███
██                 ████                                         ████         ██                ████                                               ████
██                  ██                                           ████                          ████                                             ██████
██                  ██                                            ████                         ████                                            ███████
██                 ███                                            ████                         █████                ████                       ███████
█                 ████                                            ████                         █████               ██████     ██                ██████
█              ████████                                           ████                          ███                ██████    ████                  ███
█             ██████████                             ████        ████                                              █████     ████                   ██
██           ████  ██████                           ███████     █████                                             █████       ████                  ██
█████       ████    █████                           █████████████████                                            ███          ██████               ███
██████      ████     ███                             ███████████████                              ██████        ███           ███████              ███
██████       ██                                       ████████████                              █████████       ███          ████████              ███
██████                                                  █████████       ███                    ██████████        ██         ████████               ███
█████                                                    ████████      █████                   ██████████        ███        ███████                ███
█████                                                    █████████     █████                   █████████         ████        █████                ████
██████                          ███                     ██████████     █████                   ███████    ██    █████          ██              ███████
███████                        █████                  ██████  █████   ██████     ███            ████     ████   █████                         ████████
████████                       █████                ███████    ████████████     ███████████              ████   █████                         ████████
████████                       █████               ███████     ███████████      ████████████             ███     ███                           ███████
███████                         ███                ██████     █████████        █████████████            ████                                    ██████
█████                       ██                     ██████     ████            ██████████████           █████                                     █████
████                       ████                    █████       ██             ██████   █████           ██████                                     ████
███                       ██████                    ███                        ████      ██           ████████                                     ███
██                        ██████     ██                                        ████                  ████████████                     ███          ███
██                        █████     ████                                       ████                  █████████████                   █████          ██
███                      █████      ████                                       ████                   ████████████            ███   ███████         ██
███                     █████        ██                                        █████                    ███    ██            ██████████████         ██
███                     █████                                                   ████                                         █████████████          ██
██                       ████                                              ██    ████                              ██         ██  ██████            ██
██                        ██                ████                          ████    ████                            ████             ███               █
█                   ██           ██        ██████                    ██████████   ████████                        ████                               █
█                  █████        ████       ███████                  ███████████   ████████                         ██                               ██
██         ██     ██████████    ████        ████████                ███████████    ███████                                                        ████
███       ███████████████████    ██          ████████                ██████████      ██                                                          █████
███       ███████████████████                ████████                 ████████                                                                ████████
███        ██████████████████                 ██████                      ███                                                                ████   ██
██          █████████████████                  ████                        ██                                   ██                          ████     █
██           ██  ███████████                    ██                         ██                   ████           ████                        █████     █
███               ███████                                                  ██              █████████████      █████                        ██████    █
███                ██                                                     ███             ███████████████    █████                          █████    █
███                                    ██                             ███████             ███████████████████████                             ██     █
███                                   ██████                        █████████             ██████████████████████                                    ██
██                                    ███████                      █████████             ███████  ██████████████                                   ███
██                                     ████████  ███               ████  ██        ███  ███████    █████  ██████                                  ████
██                                          █████████               ██            ███████████      ████     ███                         ██   ██   ████
██                                           ████████                            ███████████      █████      ██                        █████████   ███
██                                              ████                           ████████████       █████      ███                       █████████    ██
██                                               ███                         █████████████         █████    ████                       ████████     ██
██                                               ███                        ██████████████          ███████████                  ███  ████████     ███
██                   ██                         ████                        ███████████████          ███████                    ██████████████     ███
█                   ████                       █████                        █████████████████         █████                    ██████████████      ███
█                   ████         ██            ████                         ████████   ███████                                ██████████████        ██
█                  █████        ██████        █████                          ██████     ██████                ██             ███████████████        ██
██                █████         ███████       ██████                          █████      ██████              ████            ███████████████        ██
███               ████           ██████       ██████                           ████      ██████              ████            ██████████████         ██
████             ████              ████      ██████                             ██       █████                ██             █████████████         ███
██████         ████                 ██      ██████                                       █████                                ██████████       ███████
███████       ████                          █████                   ███                 █████                                                 ████████
███████     ██████                          ████                   █████                ████                                                 █████████
██████     ██████                            ██                    █████                ███                     ██                           █████████
█████      █████                                                    ███                                        ████████                       ████████
██         ████                                                                                                █████████                           ███
█           ██                                                                                                ███████████                           ██
█                          ███                        ██                                                      ███████████                           ██
██                ███     █████                      ████                                                    ████████████           ███            ███
██               █████    ██████                     ████                                                    ████████████          █████          ████
███              █████     █████                     ████                                                     ████████████         ██████         ████
███       ███     ███       █████                     ██               ██                                     ███████████████       █████        █████
████     █████               ████                                     ████      ███                            ██  ███████████       ███         █████
████     █████               ███                                      █████    █████                                ██████████                   █████
████     ████               ████                                      █████    ████████                             ██████████          ██  ███   ████
████    ███                 █████                  ██           ██    ████     █████████                            █████████      █████████████   ███
█████  ███                   ████                 ████         ████   ███      █████████                             ███████      ██████████████    ██
█████████                     ████               █████         ████   ██        ███████                               █████       ██████████████    ██
█████████      ██              ██████            █████          ██    ██        ███████                        ███     ███         ████████████    ███
███  █████   █████    ██        ██████            ███                 ███        ██████                       ██████                ██████████    ████
██    █████████████  ████        ██████                              ████████     ██████                     ████████                ████████     ████
██    ███████████████████        ███████                            ██████████    ███████                    ████████                    ███      ████
██   █████████████████████        ██████                            ███████████  ████████                     ███████                              ███
██   █████████████████████        █████                             █████████████████████                     ████████                              ██
██    ██   ██  ████████████      █████                               ███████████████████                      ██████████                            ██
███             ████████████     ████                                       ███████                          ████████████      ██                  ███
████            █████████████    ████                          ██            █████                          ████████████████  ████       ██       ████
█████          ██████████████     ██                          ████           █████                 ███     █████████    ███████████     ████      ████
█████████   ███████     █████                                 ████           ██████   ███         █████    ████████      ███████████   █████       ███
██████████████████       █████                                 ██            █████████████        █████    ███████       ███████████████████       ███
██  ██████████████       ██████                                               ██  ████████         ████    █████        ███████████████████         ██
█    ██████████████      ████████                                                  ██████          ████   █████        ███████      ████            ██
█     ██████████████     █████████    █████                                        █████          ██████  ████        ██████                        ██
██    ██████  ██████      ██████████████████        ██                             ████         ████████  ████    ████████                          ██
███  ██████    ████         ████████████████       ████                             ██     ████████████    ██    ████████                           ██
██████████     ███           ██████████████        ████                                   ███████████            ██████                             ██
█████████     ████            ██   ███████          ████                                 ███████████              ████                              ██
█████         █████                 ███              █████                       ███    ████████                                                   ███
████          █████                                   █████                     █████   ███████                                                 ██████
███            ████                                   ██████                    █████   ██████                                      ██         ███████
███             ██                                     ██████                   █████    █████                                     ████        ███████
███                             ██    ██                 ████                   █████     ███                                     █████        ███████
████                           ██████████                 ██                    █████                                            ██████         ██████
████                          ████████████      ███                              ███                                            ██████          ██████
████                         ███████████████   █████                                                          ██                ██████          ██████
█████               ██      ████████████████████████                                                         ████               ███████          █████
██████          ███████    ██████████████████████████                                                        █████              ███████           ████
███████        ████████    ███████████████████████████                                                        ██████             █████             ███
███████        ████████    ████████████████████████████                                             ███        ██████                              ███
██████          ███████    █████████████████████████████                                           █████       ███████████                        ████
████             █████     ████████     █████████████████                                          ██████       ███████████                       ████
███                        ██████        ███   ██████████                              ██          ███████            █████                        ███
███                        ████                  ███  ██                              ████          ███████            ███                          ██
███                       ████                                                        ████          ███████                                          █
██              ████     █████                                                       █████           ██████                                          █
██             ████████████████                                                      █████            █████                                          █
██             █████████████████                                    ██              ███████             ██                             ██           ██
██             █████████████████                                   ████            ████████                                           ████         ███
██              ████████████████                                   ████            ███████                                            █████        ███
██               ██████████████                                    █████           █████                                               ████████     ██
███  ██          ██████████████                                     ████            ███           ██                               ██    ███████    ██
████████         █████████████           ██                          ██              ██         █████          ██                 ████    ██████    ██
████████         ████████████           ████               ██                        ███       ███████████████████                ████       ██     ██
████████          ███████████          █████              ████                        ████    ████████████████████                ████              ██
█████████          ███████████        ███████             █████                ███     ████  ████████████████████                  ████             ██
█████████           ████  █████       ███████             █████              ██████     ████████   █████████████                    ████            ██
█████████            ██    █████      ████████            █████             ████████     ██████     ███████████                     █████           ██
█████████                   █████    █████████             ███               ███████     █████       ██    ████                ██  ██████           ██
█████████                   █████████████████       ██                          ███     █████               ██                ██████████           ███
████████                     ██████████            █████                               █████                                 ██████████           ████
██████                       ████████             ███████                             █████   █████                         ██████████            ████
████          █████          ███████              ███████              ███          ██████   ███████                        ████████              ████
███          ███████          ██████              ██████      ██      █████        ███████   ███████                        ███████                ███
███         ████████           █████             ██████      ████     █████        ████████   █████                          ██████                ███
███         ████████            ████            ███████     ███████   ████          ███████                                  ██████           ██   ███
███          ██████              ██            ███████      ████████   ██            ██████                                 ████████         ████  ███
███          █████                             █████         ███████                   ███                                  ████████         ████  ███
███          ████                              ████          ███████        ██                                              ███████           ██    ██
███           ██                        ██      ██           ██████        ████                                             ███████                 ██
████                                   ████                 ███████        ████                                             ███████                 ██
██████                       ██        ████          ██     ██████         ████                                             ████████      ██        ██
███████             ██     █████       ████         ████    █████         ████                                              █████████    ████      ███
███████       ███  ████   ███████      █████        █████  █████       ███████           ███                               ███████████  ██████    ████
████████  █████████████████████████   ███████      █████████████      █████████   ███   █████              ███████████   ██████████████████████  █████
█████████████████████████████████████████████████████████████████   ███████████████████████████  ███     █████████████████████████████████████████████
██████████████████████████████████████████████████████████████████████████████████████████████████████████████████████████████████████████████████████
