██████████████████████████████████████████████████████████████████████████████████████████████████████████████████████████████████████████████████████████████████ █████████████████████████████████████████████████████████████████████████████████████████████████████████████████████
████████████████████████    █████████████████████████████   █████████████████████████████████████████████████████████████████████████████████████████████████████  ███████   ████████████     █████████  ██████████████████████  ████  ██████████████  █████████████████████████████████
███         █████   ███      ███████████   ████     ████            █████   ████████████████      █████      ██████████  ██████████████████████████████   ███      ██████     ██████████       ███████    ██████   ███████████    ██    ██████   ███        ███████████     ██████   ███
██           ███               ████████     ███      ███             ███      ████  ███████        ███        ████████        ██          ███   ██████              ████            ███         ██████    █████       ████████          █████                    ███         ████     ██
██           ███                ████████    ███                                ██    ███                      ████████                           ████                                            ██████   █████        ███████          ████                                 ███      ██
██     ██                       █████████   █████                                             ██               ████████   ███                                                                 █    ████  ██████         ██████           ██                                 ███       ██
██    ████                ███  █████ █████   █████                                           ████     ███       ██████████████                                                               ████  ████  █████            █████              ██           █████              █       ███
███  █████        █      ████  ████   █████    ████               ███                       █████    ████        █████████████                         █      ██                              ████████    ███              ████            ████          ████████                   ████
█████████        ██      ████   ██    █████     ███              █████                       ███      ██         █████████████            ██    ███   ███    ████          ███                ████████                      ████         ██████          █████████                  ████
█████████         █       ██         █████                      ███████                                         █████████████            ████  ██████████    █████         ███                 ██████                        ████       ███████          █████████                  ████
█████████    ██                     ██████                     ████████                                         ████    ████             ████  ██████████     ████         ██            ██   ███████                        █████     ████              █████████                   ███
██████████  ████                   ██████            ██████   ██████████                          ██            ███              ██      ████   █████████      ███                      █████████████                        █████    ████                ███████    ████             ██
████████████████              ██  ██████            ██████████████  █████       ██               █████          ███             ████     ████      ███████                              ████████   ███     ███               █████   █████                 █████    ██████     ██     ██
█████████████████            █████████              █████████████    ████      ████       ███    █████                          ████     ████         █████                              ██████     ████  █████              ██████ ██████                  ███     ██████    ████    ██
██████ ███████████           ████████              ██████████████    ████      █████      ███     ███                  ██       ████      ██            ██                                ████      ███████████              ██████████████                         ██████    ████    ██
█████   ███████████         ████████               ██████████████    █████     █████     ███                         █████       ███      ██                          ██     ██           ███       ██████████                █████████████                          ████      ██     ██
█████   █████   ██         ████                    ██████████████    ██████    █████    ███                          █████        ███     ███                        ████   ████                     ████████                  █████████████                                          ██
█████   ████              ████                      ███████   ██      █████     ████    ███                          █████         ██     ███                        █████ ████████                   ███████             █    █████████████                              ██          ██
████   █████              ████           █           █████             ███       ███    ███          ██                ███                                          ████████████████                   █████             ████  ████████████                              ████         ██
██     █████              ████           █           █████                       ███   █████        ████     █          ██                                     ████████████████████           ██       █████         ██ ██████  ███████████      ███                     ████          █
█      █████               ████                       ███                        ███   █████       ████     ███         ███      ███                           ███████████████████           ██████    ████         ██████████   ███████████     ███        ███          ███     ███   █
█      ██████              ████                                                   █    ████        ████    ████         ████    ███████         ██             █████████    █████            ███████  █████          ████████     ███████████     █        █████         ███    ████  ██
██     ███████        ██    ███                                                        ████        ████   █████          ████   █████████      ████              ██████      ████             █████████████          ███████       ██    ██████            ██████████     ███  ████  ███
███    ███████       ████   ███                   █               ██                    ███  ███   █████  ████            ███    ██████████   █████               █████      ████                ███████████         ██████               ██████           ███████████    ████████   ███
████    █████        ████   ███                  ████            ████      ███             ██████  █████   ██              █      ████████████████                █████       ██                  ███████████        ██████                 ███             ██████████    ███████    ███
█████               █████   ██                   █████           ████    █████             ██████   ████                            ████████████                 ██████                           ███████████        ██████   ██                     ████     ████████     ██████   ████
██████              █████   ██             ███   ██████          ████   █████             ██████     ██                               █████████               █████████                   ███       ████████          █████                        ████████      █████     ██████   ████
██████               ███    ██             ███   ███████         ████   ████              ██████                                         █████               █████████                    ███        ██████            ███                   ██   ██████████      ████      █████   ████
█████                ███    ███                 ███   ███        ████    ██                █████                            ██           █████               ████████                     ███        ██████                                 █████████████████      ██         ██   █████
███             ███ ████   ████                 ██     ███       ████                           ███                        ████          █████                ████            ███████     ███       ████████                         █      ██████  █████ ████                     █████
██              ███████    ████                ███      ███       ██                            ██████████     █           ████        ████████         █     ██             ██████████   ███      █████████    ██                          █████    ███   ███           █         █████
██              ███████    ████   ███          ███      ███                            ████    ████████████    ██          ████       ████████████            █              ███████████  ███      █████████   █████████                    █████                        █         █████
███              ██████    █████ █████        ████      ███                          ██████████████████████    █           ████       ████████████                            ██████████            ███████   ███████████              ██   ████                                   █████
██████           █████     ███████████       ██████                                 ██████████████   ██████               █████        ███████████                                   ██               █████   ███████████             ████ ████                   ██               █████
███████           ███      ██████████        █████                                   ████████████     █████         ███   ██████           ██████                                                       ███   ███████████           ███████████    ██            █████              ████
████████                  ██████████         ████                                     ████████████     ████         ████   █████            █████                         ██                                   █████████           ████████████    ██     ███    ████████            ███
████████                ██████  ███          ███                                       ███████████     ████         ████   █████            █████████              █     ████                     ███           ███████           ████████████           █████    ████████      █    ███
███████     ██         ██████                ███                                        █████  ██      █████         ██    ██████          ███████████            ███    █████  ██      ██        ████           █████           █████████████          ███████   ████████     ███   ███
██████     ████         ████                  █                                         ████            ████                ███████      █████████████            ██      ████████    █████       ███████        ████             █  ████ █████          ████████████████           ████
███       █████                                                                          ██        ███  ████                 ███████    █████████████    ███     ███       ███████   ███████      ████████      ████                  █    ████              ███████████            ████
██       █████                                                             ██                     ██████████                  ██████     █████   ██       █     █████                ███████       ████████    ████                        ████               ██████████           █████
██      █████                          ████                                ██                     █████████                   ███████     ████                  ██████                ██████        ███████    ████                         ██                █████████         ████████
██     ██████           ███         ████████                                                      ████████                   ████████      ██                    ███████              █████    ███      ████  ████                                           █████████    ██████████████
███   ███████    █      ████       ████████           ███                                        █████████                   ███████                              ██████               ███   ██████     ██████████                                          █████████    ███████████████
███   ██████     ██     ████      █████             █████                                       █████████                     █████                                ████         ███          ███████    ██████████                              █          █████  ██     ███████   █████
██    ██████     █       ██       ████             ██████             ██                       ████████         ████    █     █████                      █         ███         █████         ████████   ██████████                   ██        ████        ████         ███████     ████
██   ██████                       ███              █████   ███        ███                     ████████         ██████  ███     ███                      ███         █       ████████            ████     ████  ███      ██          ████        ████       ████         ██████      ████
██   █████                                          ████   ████       ███    ██         ███  ████████           ████    █                               ███                ██████████                    ███    ██     ████    ██  ████          ███      █████          █████      ████
██  ██████            ███                            ███   ████        █    ████       █████████████                                                    ████               ██████████                    ███    ██      ██    █████████    ██    ███      █████             ███    █████
█████████            █████  ███                       ███ ████              ████      ███████                                                            █████             ███████████    █                     ██            █████████    ██     ██      ████               ██   ██████
████████        ████████████████                      ███████               ███       █████                                                    ███       ██████             ███  █████   ███    ██              ██            ██████████  ████    ███     ███                ██   ██████
████████       ███████     ██████         █    ██     ██████      ██        ██         ███                                   ██               █████      ██████                   ███     █    ████             ██    ██      █████████████████   ███     ███                      █████
████████       ██████       ██████             ███   ██████      ████      ███                                              ████              ██████     ██████                                ████             ██    ███      ███   ██████████           ███                        ███
███  ███       ██████        ██████            ████████████      █████    █████  ███                                     ████████      ███    ██████    ███████                                ███        ███  ███    ████           █████████                                        ██
███            ██████         █████             ███████████      █████    █████████████              ███                █████████     █████    █████    ██████                       ███       ███       █████████    █████          ████                            ███████  ███     ██
████           ███████         ████ ███         ██████████        █████   ██████████████             ████               █████████     █████      ███    ██████   ███   ██            ███      ████      ███████████  ████████        ███                             █████████████    ██
████            ███████        █████████        █████████          █████   ███████  █████             █████████         ████████      ██████      ██       ███  █████████            ███      ████     ████████████████████████       ██                                ██████████    ██
███              ██████       █████████         ████████           ██████   █████    █████████         █████████        ███████        █████      ██        █████████████                     █████    ███████   ███████████████       ██                                █████████    ██
███      ███      █████       ████████          ████              ███████             █████████         ████████        ████            ███                 ████████████                     ██████     ██████   ███████████████        ██                                    ████    ██
████      █       ██████     ███████           ████               ███                  ████████           ██████       █████                                 ███████████                    ██████         ██    ███████████████         ███  █                                ███   ███
█████            ███████     ██████            ████      ██        █                        ███            ████      ███████                                  ██████████     ███            ██████               ██████████████           ██████             █                 ███   ███
██████           ███████     █████       ███    ████    ████                 ██                                    ██████████    ███           █                  ██████    █████           █████                 █████████████           █████                               ████    ██
██████           ███████      ███        ████    ████   █████               ████                    ███           ██████████     ███          █████                ██████   ███████         █████       ████       █████████████           ████                          █████████    ██
██████           ████████                 ████  ██████ ████████            ███████       ██         ███          ████████        ██           █████████             ████████████████        ██████      █████       █████████████          ████                   ███   ██████████    ██
██████           ████████                 ██████████████████████          █████████    █████        ███        ██████████        ██           ██████████     ███    █████████████████       ███████     ██████      ██████████████         █████                 █████████████████    ██
███████         ██████████  ███   ████   ██████████████████████████████████████████   ███████████  ████      ████████████       ████    ███   ███████████   █████  ███████████████████     █████████     █████     ████████████████       ███████      ██    ██████████████████████  ███
████████████████████████████████████████████████████████████████████████████████████████████████████████   ███████████████    ██████████████████████████████████████████████████████████  ██████████████  █████  █████████████████████████████████    ████  ████████████████████████████
█████████████████████████████████████████████████████████████████████████████████████████████████████████████████████████████████████████████████████████████████████████████████████████████████████████ ██████████████████████████████████████████████████████████████████████████████
