████████████████████████████████████████████████████████████
█  █ █ ███    █ ██          ██ █  ██  ███    ██ █ █ █      █
█  █ ██ ██   █  ███ █████ ██ █  ███ ██ ██ █  █ ██ █    ███ █
██    █ ██ ██ ███ █ █ █    █ ██ █ ██     █ █ ██ ███    ███ █
█ ███ █ ███ ████ █████████ █  █  ██ ██ █  ██   ███   ██  █ █
██  ███  █ ███ █ █ █  █ █ █  ██   █  ██ █   ████  █ █████  █
███   █ ███████      █    █ █   ██  ██  ████ ███  █ ████ ███
█ █ █ █ ██ █ █ █  ███    █ █   ██  ██ █ ███  █   █ █ █    ██
█  ███ █ █    █ █ █████ █  █   █  █████ ████      █  ███   █
█  █  ██ ██  ███  █ █   ██ █ ███ █     █    ██      █  █████
████  █ █      ██ █  ███  ███ █ ██  █ █  ██ ██ ███   ██   ██
█  █ ██  █ ██    █   █   █       █   ██       █ █  █  █ █  █
██ █   ██ █ ██ █   ██      █  █    █  █  █  ██  ███████ ████
██  █ ██████ █  █ █  █   ██ █ █  ██ █ ███   ██  █   ██ █ ███
█ █  █ ███  █   █████    ██  █    ███ █ █    ███ ████ ██ ███
█  ████ █████  ██    ██  ██ █ █       █   ███ ███ █  █   █ █
██ ██  ████  ████ █ ██ █ █ ██ █   ████ ██ █ ███  █ █    █  █
██    ███ █ █  █   █ █  ███  █      █   ██ █    █  █  █ █  █
█████   █ █    ███   ███  ██ ███ █    █ █       █ ██    ██ █
████ ██ █  ██   ██ ██ ███     █ ██  █ ████    █  █    ███ ██
█  █████ ███  █  ███   █  █ ███  █  █ █ ████   █  █ █ ██  ██
█    ████ █ ██ █     █████  ████  █ █ ███   █ ██ █ ██   ██ █
█  █ █ █ █   █  █  ███████  ██ █ █ █ ██  █       █ █ ██    █
███  █  █ ██  ██ █ █ █  █ ██   █   █  █   ██ █ █      ███  █
█ █  ██   █   ███ ██    █   █ █ █████ █ █ ████  ████ ██   ██
█   █ █  ██ █ █ ██  ██████ █     █         ███  █     ███ ██
██  ██ █ ██ █ ██   ██ █ ██  ███ █    ██ █  ███  █ █ ███  █ █
███   █ █  █ █ ███  █       █ ██  █ █████   ██      █ ██  ██
█ ██ █   ████ ██      ██  █ █ █     █ ██ █  ██    ███ ██████
███ █    █  ██  █  ██ █  █    █  █  █ █ █ █████ █ █    ███ █
█ ████ █ ███  █ █████████  ██  █ █  ████ █ ██   █ ████ ███ █
█ ██  █ █ ██ ███     ███ ██     █    █    █  █ ██ █    █ ███
███  ██  █ ███ ██ █      █ ██    ██  ██ ████   █ ██ █  █  ██
███  █ █ █ ███ ████  ██ ███ █  █  █ ██    █ █  █     █ █ █ █
██ █   ███ █  █   █████  ██  █   █████ ██   █  █ ██ █  ██ ██
██ ███  █ ███   ██  ██ █  █ ███ █ █  █ █  ████  █ █    █ ███
██     ██     █    █  █ █ █ ██   █ █ ██████ ███      █ █ ███
█  █      ██ █  █    ██ █   █  █  █    █████ ███ █ ███ █████
█ █ █ █        █   █ █       ██   ██ ███  ███  ██ ███ ███  █
█ █████   █   █ █ █   █ ██ ██ █  █  █     █     ██  █     ██
█ █ █  █ █  █    █ █    ███  █  █ ██     ██ █   █ █    ██  █
█      █    ███  █ █ █   ██ ████  ███    █  █  █  ██   ██  █
█ ███   ██ █  █  █  ██        █    █  █   █   ██    ██ █  ██
█ ███   ██   ██  █ █ ██   █   █ █  ███  █████    ██ ██  █  █
█ ███ ███  █ █ ███  ██ █ ██     ███  █   █  █ ██  █   █    █
█ ██ █      ██ █     ████ ██  ██         █ █     ███     █ █
███   █ █ █   █ █ ███          █ ██  █ █    ███  █ █   ██ ██
█ ███   █  ██   █  █ █ █ ███  █████ █ ███ █ ██    ███  █████
██  █ █ █ █  █ █ █     █  ███ █ █ █    █  █ ████   █ ██   ██
█ ██ █  █    █ █  █ █ █  █ █ ██ ████ █  ███ █ ██████ ██  █ █
█   █  █ █  █  ███  █   █     ██  █ █    ████ █ ████   █  ██
██ █  ██ █     █ █ █   █████ █   ███    ███ ███ ████     █ █
██ █ ███  █   █    ██████ █   ██  ██ ███  ██  █ ███    █ █ █
██ █       ██     █    █ ██  █ █    █  ███      █  ██ ██ █ █
█  ████ █  █  █ ██  █ █ █  ██████ █ █ █  ██  █   █    █ █  █
██       ████    █ ███        █         █  █ ██  ███████   █
█    ███   █   █  █   █  ██   █ ██ █ ███    █   █     █ ██ █
█    █ ██ █ █████ █  ███ █████ █ █  █  █ ███  ██   █  █  █ █
██████ █ █     ███    █   █ █   ███     █  █       █ ██ █  █
████████████████████████████████████████████████████████████
