████████████████████████████████████████████████████████████████████████████████████████████████████████████████████████████████████████████████████████████████████████████████████████████████████████████████████████████████████████████████████████████████████████████████████████
████████████  ██████████████████████    █████████████████████████████████████████████  ███████████████████████████████████  █████████████  ██████████████████████████████████     ██   ███████████████████████████████████████████████████  ███████████████████    █████████████████████
███████████    █████████████  █████      ██████     ██████████   ███████████████████    █████████████████████████████████    ████████        ████████ ███████  ██  ██████                             ████████ ███████████  █████ ███████    ███████████   ███      ████████    ████████
███████████     ███████████    ████       ███        ██   ████    ██████████████████    ███████  ████████████████████████     ██████          ██████   ████         ████                               ██████   █████████    ███   ██████     █████████             ███████     ████████
███████████      █████   ██     ████                       ████   ███████████████████  █████      ██████████  ██████████       ████           ██████    ██          ███           █                     █       █████████    ███    ██████    ██████████             ███████    ████████
████████████                    ████                        ███    ███     █████   ████████       █████  ██    ███████                         █████               ████          ███                            ████  ██     ███    ██████    ███████████            ███████    ████████
████████████                    ████                        ███                     ███████        ██          █████                            ███            ███████           ████████                        ██          ███     █████     ██████████            ███████     ███████
████   █████                     ██                         ████                     ███████                   ███                                             █████              ████████                                    █      █████        ███████     ███    █████        ██████
███      ██                                                 ████                     ███████                   ██                                       ██     ███         ██     ████████                                           ██████        █████     ████    ████          █████
██                                                           ██                      ██████                   ███                          ███          ███              █████     ███████           ████          ███               ████████     █████      ████    ████           ████
██                               █                                                   ██████                   ███                           █           ████            ███████      ████           █████         ███████           █████████████████       █████     ███           ████
██          ██                   ██                    ██          ███   ██████       ████                    ███               █                       █████          ██████████                  ██████       ███████████         ████████████████       █████       ██            ███
███        ████                  █                   █████        ███████████████      ███                    ███              ███                      ██████       ████   ██████          █     ████          ████████████        ███████  ███████     ███████                     ███
████████████████  ██████                            █████        █████████████████     ████                  ████              ███                     ███████████  ████    ███████        ███    ███           ████████████       ███████    ██████    █████████                     ██
█████████████████████████                            ██          ██████████████████     ███                 ████              ███                      ███     ████████     ████████       ██     ███           ████████████       ███████     ████     ██████████████                ██
█████████████████████████                                        ██████████████████     ███                ████              ████                    ██          ██████    █████████████           █            ████ ████████     ███████               ███████████████               ██
███   ███████████████████           ██                     ███   ███   ████████████     ███                ████             █████                    ██           █████   ███████████████                      ████   ███████    ███████                 ██████████████               ██
██               ███████           ████                   █████  ███    ██████████                        ████              █████                    ███           █████████████████████                █      ████   ███████    ███████                    ████████████              ██
██                █████           ██████                  █████  ████       ██████                        ████              █████          █         ████          ███████████████████                         ███         ███   ███████                     ███████████              ██
██                                ██████                   ███   ████        ████                          ████              ████        ████        ████     ██    █████████████████                                       ███  ███████                      ██████████              ██
██      ██                         █████                         ████                          ██           ███████  ███      ██        █████        ████    ████    ████████████████                                        ███████████                       █████████              ██
██      ██                           ██                          ████                         ████          ████████████                ████         ███     ████     ██████████  ██                                         ██████████           ██           █████████    ███       ██
█      ██             ██                                ██       ████             ██         ███████████    ████████████                 ██          ███    █████      ███████                      ███                      █████████           ████           ███████    █████      ██
█     ███            ████                               ███      █████████       ██████     █████████████   ███████████                             ████    █████       ███                        ████                       ███████            ████            █████     █████     ███
█    █████            ██       ██   ███                 ██        █████████      ███████   ███████  █████  ████     ██     ████                     ████    ████                                    ███                         ████              ██    ███       ██       ██████   ████
█    █████                    ██████████                            ████████     ████████████        ████  ███            ██████                   ████     ██                                                                   ██                     ███                ██████   ████
█    ████                    ███████████                            ████████     ███████████          ████████    ██       █  █           ███      ███                                   ██                      ██                          ███        ███                ██████   ████
█            ███            ████████████                            █████████    ████  █████          █████████  ████              ███   ████      ██                                   ███████                 ████                           ███                         ██████    ███
██           ████         █████████████             ██         ████████  █████    ██    ████          █████████  █████             ███   ███      ███                          ██████   ████████                 ████                         █████          ██           ███████     ██
███          █████       █████████████             ███        █████████   ████          ███          ██████████  █████            ████           ████         ███              ███████   ████████████            ████                         █████         ███           ██████      ██
███           █████      ████████████             ███         ██████████   ██                        ██████████   ████          █████           █████        █████               █████     ██████████            ███                         ███████       ████            ██         ██
███           ██████      ████   ████            ███           ██████████                             ████████     ████        █████            █████       ███████               ████      █████████           ████                        █████████     ████                        ██
███           ███████             ██            ████            █████████        ██                   ██████       ██████       ███              ███       ████████               ███       ████████            ███                        ███████████   ████                         ██
███            ██████                           █████  █        █████████       ████          ██      █████        ███████                                 ███████                 █        ███████             ██                         ███████████   ███                          ██
██              ████                            █████████        ████████   ██   ████        ████      ███         ███████                                 ███████                           ██████            ██                          ██████████     █                           ██
██                                             ██████████           ████   ████  ███████    █████      ████        ███████                                  █████                             ██████           ██                           █████████           █      █████          ██
██                                             ███  █████            ███   █████  ███████   ████        ████        ██████       █                           ███                               █████                                         ████████         ████     ██████         ██
███                   ███     █████████       ███    ████           ███    ██████  ██████    ██          ████        █████      ██               ██                                ███         ████                                            ███████       ████      ████████       ██
███                ████████  ███████████      ███     ████          ███    ██████   █████                ████████    ██████      █    ██        ███                                █████       ███                                              ███████     ████        ████████      ██
███               █████████████████  ███      ███     ████           █     ██████    ████           ███ █████████   ████████         ████      ████        ██                      ██████     ████                                              ███████     ███          ███████     ███
████     ██      █████████████████    ██       █      ████                 ██████    ████          ███████████████ █████████         ████       ██        ████                      ████     ██████                                   █████      █████      ██           ██████      ███
████████████     ██████████████       ██              ████                  ████      ███       ███████████████████████████           ███                  ███                               ███████                                   █████                            ██████      ████
████████████      █████████████      ███           ██████                   ████      ███      ████████████████████████████                                 ██                               ████████                                   █████                          ███████      ████
████████████         ██████████     ████          ███████      ███          █████     ███      ████████████████████████████                         █                                        ████████                 ███                ████           ██             ███████       ███
████████████          ██   █████   █████          ███████     ███████████  ██████    ████      ███████████  ███████████████                        ███                                      ████████                  ███                 ███          ████       ██  █████████       ██
███████████                 ████████████           ███████    ██████████████████    █████      ██████████    █████████████                                    ██            ██             ███████                    ███           ██    ███          █████     ██████████████       ██
████████                     ██████████         ██   █████    ████████  ████       ███████  ███ ████████     ███████████                                      ███          ███████          ████                      ███          ████   ████     ██   █████    █████████████        ██
███████       ██             ██████████        ████   ████     █████               ████████████  ████        ██████████       ██                             ████          ████████                   ██  ███          █           ████   █████  ████   █████     ██████████          ██
██████       ████           ██████████        █████   ████     ████                 ████  ████   ███          █████████      ████                            ████           ████████                 ██████████                     ██    ███████████   █████      ████████           ██
█████         █████        ██████████    ██   ██████   ███      ██                              ████           ████████     ███████                           ██               ██████                ███████████                          ███████████  ██████       ██████            ██
████           █████      ██████████    ████   █████   ███      ██                              ████   ██       ██████      █████████                               ██████      ██████              █████████████                        ███████████   ██████        █████            ██
██              ████      █████████    █████    ███             ██                              █████ ████      ██████      ██████████                             ████████      █████████         ███████████████           ██          ██████████   ████████████    ███             ██
█       █       ███      ██████        █████                   ███                               █████████       █████      ██████████                            ██████████     ██████████        ███████████████          ████         █████████    ████████████                    ██
█       ██      ███     ████           █████                  ████                       ██      ██████           ████      ██████████     ███                    █████████      █████████                 ███████          ████         █████████   ████████████                     ██
██      ██              ███             █████               ██████                      ████    ██████            ████       █████████    █████      ██            ██████        █████                       █████           ████        ██████████ ██████████                        ██
████   ██              ████             ██████             ██████                       ████    ██████            ████        ███████     ██████  ██████             ███         █████                        █████           ███        ████████████████████                         ██
█████████              ████             ██████             █████                         ███    ███████          ██████                   ██████████████                          ████                        ██████           ███       ████████████████████                        ███
██████████       ████   ██               ██████            ████                          ████    ██████████     ████████                    █████████████    █                     ███                        ███████          ███       █████████   ████████                 █      ███
██████████       █████                    █████             █                           █████     ██████████   ██████████                    ███████  ████  ███                    ████  ██████████           ████████         ███      █████████       ████                 ███    ████
█████████        █████                     ████                                        ██████     ██████████   █████████           ██         █████    ███████     ██               ████████████████          █████████████   █████    ████              ██                 ████   █████
████████         ██████                     ██        ██                               █████      █████████     █                 ████        █████     █████     ████               ███   ███████████       ██████████████████████   ████                                 █████   █████
████████         ██████████   ███  ██                 ███                               ███       ███████                         █████        █████    ████     █████                      █████████████   ██████████████████████     ██             █                    ████    █████
███████          █████████████████████                ████                                       ███                               ████        █████     ███     ████    █                  ██████████████████████  ████████                         ███                   ████   ██████
███████           ███ ████████████████                 ███████  ███      ██        ██        ██████         ██                     █████        ████      ██     ███    ███                ██████████████████████        ██                          ████                   ██    ██████
███████      ██        ████████████████                 ████████████    ████      ████      ███████        ████                   ████████████ █████      ███   ████    ███             █████████████████████████                             ██     ████             ██         ███████
████████    ████      ██████████████████               ██████████████  █████████████████████████████     ███████        ███      ████████████████████    ████████████  ████            ██████████████████████████████        ██              █████  ██████    ███   █████        ███████
█████████████████████████████████████████   █████████████████████████████████████████████████████████████████████████  ██████████████████████████████████████████████████████████████████████████████████████████████████  ████████████████████████████████  █████████████      ████████
████████████████████████████████████████████████████████████████████████████████████████████████████████████████████████████████████████████████████████████████████████████████████████████████████████████████████████████████████████████████████████████████████████████████████████
