██████████████████████████████████████████████████████████████████████████████████████████████████████████████████████████████████████████████████████
██       ████                ██████    ██      ██    ██  ███   ███████████   ███        ███  ██████   ████       ███                     ███       ███
█         ██                   ██                                                             ███                                                   ██
█                                                                                                                                                   ██
█                                                                                                                                                   ██
█                                                                                                                                                   ██
█                                                                                                                                                   ██
█                                                                                                                                                   ██
██           ██████     ███            ████    ███████                  ███   ████████          ████      ██       ███      ██  ██        ██       ███
██████████████████████████████████████████████████████████████████████████████████████████████████████████████████████████████████████████████████████
