████████████████████████████████████████████████████████████████████████████████████████████████████████████████████████████████████████████████████████████████████████████████████████████████████████████████████████████████████████████████████████████████████████████████████████
██████████████████████  ██████████████████████████████████████████████████████   ███████████████████████████████████████████  ███████   ████████████████████████████████ ██████████████████████     ███         ██████████████████████████   ███████████████████      ████████   ███████
████  ███████████████    █████ ████████████  ███████████████████████  ███████        █████████       ███    █████  ██████      ███       ████████████     █████████████   █████████████   ████                   ████████████████████  ██     ███████████   ███        █████       █████
███    ██████████████     ███   ████  █████     █████ █████████████    ██████        ███   ██                ███     ███                  ███  █████       █████████████   ███████████                            █████████   ██████           ██████                  ████         ████
███    ██████   █████     ███    ███ ████████     ██   ████████         █████         █                       █                                            ██████████████   █████                                 ████████     █████              ██                   ███           ███
███   ██████     █████    ████    ████████████        █████████         █████                                                                             ██████   ███████   ███                  ██             ████████      █████                            ██    ███             ██
██    █████      ██████  █████     ███████████        ████   ███         ███                                                                              █████     ██████                        ████           ███████        ████       ██                  ██████████             ██
██     ███      ██████████████     ████████████      ████    ███                                                ████                                      ████      ██████                        █████           ██      ██   ████        ██             ███████████████             ██
█               ████   ███████     ██████  █████     ███     ████                          ███                 ██████      ██          ██             ██   ██       █████                          ███                   ████████          ██             ██████████████              ██
█                █      ███████    █████    █████    ██      █████                         ███                ███████      ███     ███████            ██           ██████                                                ███████                         █████   ██████               ██
█      ██                  ████   ██████    █████             ████                         ███               ███           ███    ████████                        ███████                                 █               █████                         █████                        ███
█     ████                  ████ ██████     █████              ██       █                   ███             ███            ███    ███████                        █████████    ██             ██          ███                                            █████           ███         ████
█     ████                  █████████        ████       ███            █████          ██    ███           █████                   ██████      ███                ██████████  ███          ██████████     ████                                            █████         █████       █████
█      ██            ███    ████████          ██        ███             █████         █     ███          ██████                    ████       ████               ██████████████          █████████████   ████                                             ████        ████████     █████
██              ████████████████████                     ███             ████        ██          ███     █████                      ███       █████████  ███      ████████████          █████   ██████████████        █████                               ████       █████████      ████
██             █████████████████████                      ██████         █████      ███         █████     █          █              ████       █████████████        ██   █████           █       █████████████       ██████               ████            ███       ██████████       ███
██      █     █████████████████████          ██           ██████        ███████    ███          █████               ███             █████       ████████████              ████                    █████████████      ██████               █████           ███       ██████████       ███
██     ██     ████ ████████████████         █████          █████      █████████    ███          ██████               ███            █████        ████████████             █████                       █████████       ████                ██████         ███       ██████████        ███
███     █     ███  █████   █████████        ██████                    █████  ██   ████         ██████      ████      ███           █████          ██   ██████             █████                        ███████                    ██      ██████        ████       ███████          ████
███           ████ ████         ██████       █████                    ████    ██  █████       █████       ██████    █████          █████               █████               ████     ████                                         ████    ██████        ████         █████       ████████
███            ███████          ███████       ███                             ███  ██████     ████        ███████   ██████         ████                 ████               █████   ██████                                   █   █████    ████         ████           ███      ██████████
██               ████           ███████                                       ███  ███████     █          ████████   █████        █████      ██         ████               ███████████  █     ██                           ███  ████      █          ████      ███           ███████████
██      ██                      ███████                                      ████   ██████                   ██████   ██         ███████    ████         ███               █████████         ████    ███                    █    ██                 ████       ████         █████  █████
█      ████                     ███ ███     █████                           ██████   █████                    ██████             ███████████████         ████              ████████          ████    ███     ███                                    ███         ████       █████    ████
█      █████                         ██     ██████                         ███████    █████                   ████████            ██   ██████████         ████             ███████            ██      ███    ███                                    ██          ████      ████       ███
██      ██████                       ██     ██████                         ███████    ████████████           ███████████                █████████         █████            ██████      ██             ████    ███                                   ██    ██     ███       █          ██
███      ██████                     ███      █████                          █████      ████████████         ███  ████████    ██             ██████        ██████          ███████     ████             ███    ███                                  ███   ████                         ██
█████         ███                   ████      █████                    ██     ███       ███████████         ██   █████████  ████              █████      ███████          ████████    █████            ███    ███                                  ███   ████                         ██
███████        ███                 ████████    ████        █          ████     ███       ███   █████       ██    ████  █████████               ████     █████              ███████    ██████            █     ████                            █    ███    ██                          ██
████████       ███                ██████████   █████       █         ██████    ███              ████             ███     ███████     ██         ████  ███             █     █████      █████   ██             ██████                         ████ ████                                ██
████████       ██               ██████   ██    ██████               ███████    ████             █████                     ███████   ████████    ████████             ███                 ███  ████            ████████                      ███████████            ████               ██
████████       ██              █████          ████████              ██████     ████        ██   ██████                      █████   █████████   ████████             ███                       ██              █████████                   █████████████           ████   ███          █
████████                      █████           █████████  ██        ██████      ███        ████   ██████               ███    ███     █████████ █████████            ████                                        █████████████              █████████████                  ███          █
██  ████                      █████           ██████████████       ██████      ███        ████    █████             ██████              █████████████████           █████       ███                                    ███████              ████████████                  ███          █
█    ███                      ██████         ████████████████      ██████      ███        ███     █████             ███████               ███████     ████           █████      ███                                      █████                 ████████                                █
█    ████                     ██████         ██  █████████████      ████        █         ███      █████  ███         █████                █████       ██             ███       ███                                         ████                ██████                                 █
██   █████                    ██████        ██   █████   ██████      ██                   ███      ███████████          ██         ██      █████                               ████                                          █████               █████                                ██
██   ███████                ███████   ██    ███   ██      █████                          ████       ███████████                   ████     ████                                █████                          ███            █████       ██      ██████  ██                         ████
██   ████████              ███████   ████   ███████       █████                          ████        ███████████                  ████      ███                                 ████               ██        █████████        ███        ███      █████████████                    █████
██    ███████  █           ██████    ████   ██████        ████                            ██        ████   █████                  ████      ███               ██                 ██                ███      ███████████                   ███     ██████████████                   █████
██        ██  ███          ██████     ██    ██████         ███               ███                 ██████     ███                   ███      ████              █████████                              ██     █████████████                   ██     ████████   ███          █         ████
██            ███             ████          ██████          ███             █████               ██████                            ██    ████████            ███████████                                    █████     ██████                      ████████     █     █    ███         ███
███           ████            ████           █████           █               █████             ███████                                ██████████            ██  ██████                   ███               ████       ██████       ████         ████████            ██    ███████    ███
████           ███            ████            ████                              ███           ████████                               ████████████                                       █████              ████         ████      ██████       █████                █      ███████   ███
████████        ██      ██    ████             ██                                █          █████████                                █████████████                                     ██████              ████          ██       ██████      ████                          ██████   ███
█████████              ████  ████   ███               ███                    ██            █████████                      ███        █████████████                                     █████               █████  ███             ██████      ███                           ███████   ██
███  ████             ███████████   ████    ████     ███████            ██  ████          ████████                        ████      ████    ██████    ██                                ██                 ███████████             █████     ████                               ███   ██
██                    ███████████   ████    █████    ███████████       █████████          ███████                          ████    ████      ████    ██████                                                ███████████                ██    █████                                █    ██
██                   ████████████    ██      ████    ████████████      ██████████         ███████                ███       ████    ███         ██     ██████                                     ███        █████████                  ██  ███████                                    ██
██                   █████████████           █████    ███████████      ███████████  ██   ███████                 ██████   ████      █          ██      █████                              ██    █████                   █              ██████████                                      █
██                    ██████   ████           ████     ██████████      ████   ██████████████████                 ████████████                   ██      ███                              ████████████                  ███              ██████                                         █
██                              ███           ███       █████████      ████    ████████████  ██                     ████████                    ███     ███                              ████████████                 ████               ████               ██                         █
█                               ███            ██         ███████       ██         ███████                           ██████                     ████    ████                            █████████████               █████                ███               ███████                    ██
█                                ██  ██        ██          ██████                   ██████            ████           █████                       ███    █████████                     ██████████████                ████     ██         ███              █████████                  ████
█                                  █████       ███          █████                   █████         ██████████          ██                 ██      ███    ██████████                   ██████████████                 ██      █████       ███             ██████████                 █████
██            ██                   ██████      ███           ████                   █████         ██████████                 ███        ████             ██████████                 ██████████████                           █████      ████           ████████              ██    █████
██           ████                   ███████    ███            ██                    ██████        ██████████              ██████        ████                   █████                ██████████████                           ██████     █████       ██████████              ████   █████
███         █████                    ███████  ████                                   ██████         ██████               ██████        █████                    ████                 █████████  ██                            ██████     █████     ████████        ██      █████   █████
████        ██████                      █████████                                ██    █████                              █████      ███████                     ████    ███          ████████  ██                               ██       ████     ███████        ████   ████████  █████
█████          ████                      ████████       ██                      ████    ████   ███                        █████     ████████                     ████   █████          ███████  ██                                         ███      ██████        ████  ████████████████
██████          ████         ██            ███████      ███    ███              ████     ██   ████                         ███      ███████             ██        ██    █████          ███████   ██                                         █        █████        ████  ████████████████
███████         ████        ████              ████      ███    ███               ██           ████         ██                       ███████              ██             █████          ███████            ██                                           ██         ███    ███████████████
███████        ████         █████              ███      ███    ███                            ████        ████                      ████████             ███           ██████          ███████            ████  ██                                               ███     ███████████████
███████       ████           ████              ███      ███    ████                           ████        █████          ██         ███████████           ██        █████████          ███████            █████████                                           █████     ████████████████
████████     █████           █████            ████     ████    ████          ███             █████       ███████        █████████  █████████████          ██       ██████████           ███████   ██      █████████      ██              ██                 ██████     █████████████████
█████████   ██████      ███████████        ████████   ██████  ██████        █████       ███████████    ████████████    █████████████████████████         ████   ██████████████    ██    ██████████████   ███████████     ███  ███       █████              ███████     █████████████████
███████████████████    ██████████████████████████████████████████████████  ██████████████████████████████████████████████████████████████████████  ██████████████████████████████████  ████████████████████████████████ █████████████  ████████   ███    ██████████   ██████████████████
████████████████████████████████████████████████████████████████████████████████████████████████████████████████████████████████████████████████████████████████████████████████████████████████████████████████████████████████████████████████████████████████████████████████████████
