██████████████████████████████████████████████████████████████████████████████████████████████████████████████████████████████████████████████████████
██   ███ ██ █ █ █  ██ █    █ ███ █  ██ █████  ██  █ ████    ██ ██    █ █  █ █  ███  ██ ██  ████ █  █   █  ███ ██  █       ███ █████ █ ██   ██  ████  █
█████  █ ████ ██ █████  ██ ███   ████ ███     ██  ██████████ █   █    █  ██████ █    ██  █    ██  █   ███ ███  █ ██ █ ███  █         ██   █  █████  ██
█  █ █ █ ██  █ █ █    █ █ ███   █ █████  ███ ████  ███ ███  ██ █  █     █ ██ █ █ ██   ███  █ █ █ █ █  █ ██  ██  ██  █ █ ██ ██ ███ █          ███ █  ██
██  █ ██  ██  ██  █  █   █ █  █  █   █ █ ██ █  ██    █            █ ████    █   █   █  ██    █ █  ███  ██  █ ██   ███   █  ██     █   ██   ██ █  █ █ █
████   ██  █  █ █  ████ █     █    ██ ██ █ █ █  ███ █  █ ██ ████    ████   ███ ██   █  █       █ █ ██  █ █  ███ █      █  ██  ██ █     ██   █  ██  █ █
█     █  ███   █ █ █  ██  ██ ████ ████ ██ █  ██ █ ████     █  ██   █      █ █  ██████ █ █ ███   █     ██ ███   █ ███ ██   ██ ██████  █  ██           █
█ █ ██ █████   █  ███ █ █     █   █ ████ ██ ██ ██            █  █  ███  █ █ ███████   █████     █ ██      ███     █ █  █      █ █ ██    ████   █   █ █
█   █   █  ███ ████   ██  █  █ █  ████ █  ██   █ ██   ████ █  █ █ ████  ██ ███ █ █ █████    ███ ██████  ███ █ █   █ ██        ██ █    █     █ █      █
██     ██  █   ███    █   ███   ███ ██    █ ██   █ █  █    █ ██ █   █ ████ █ ██   ██  ██ ██     █   ██  █  ██        ██  ██ █   ██ █ █ ██ █     ███  █
███ █           █  █ █ ██   █  █ ███  █      ██  █   ██  ██  ██  ███     █ █    █  █    ██ █  ██   ███ ██   █     █  █ ████  ████   ██ ██ █  ██  █ █ █
█  ██  █       ████  █ █     █    ███  █   ███████ ████    ███ █████ █ ██  ████ █████   ███  █  █ ██    ██    ███  █ █ █     █ █ ██ ████   ████ ████ █
██  █ █ ██  ██ █   █ █ █ ██ ██   █ ███  █ █  ██  █ ████   █   █  █  █ █   █    ██ █  ██     █ █ ██   ██████     █  █ █ █   █    ██ █████   █ █  ███  █
██████████████████████████████████████████████████████████████████████████████████████████████████████████████████████████████████████████████████████
