█   ████████████████████████████████████████████████████████████████████████████████████████████████████████████████████████████████████████████████████████████████████████████████████████████████████████████████████████████████████████████████████████████████████████████████████
█    █████████████████████████████████████████████████████████████████  █████   ███   ██████████████████████████████████████████████████████████    ███████████████    █████████████████████████████████  ███████   ████████████████████████████████████████████████████████████████████
█       ████        ████████   █████████████████     █████████  █████                   ███████████   ███████  ███████        ████  ████  ███          ████████         ███     ███████████████████████    █████      ██  ████   ████████████████████████████████  █████████████     ███
█        ██          ██████      ██████████████       ███████    ████                      ███████      ████                                             █████          ██       ████████████████   ██      ████                  ███████████   █████████   ████    ███████████       ██
█        ██           █████         ██████████       ████████     ████                      ██████                                                                     ███        ██████████████             ████                  ███              ████            ██████████        ██
█        █              ██           ████████     ███████████      ██████                    ██████                                           ███                    ██████                █████             █████                                                  ███   ████       ███
█       ██                             █████     ████████████       ██████                   ███████              ██████                     █████      ██       ██████████                 ███               █████                                                ███     ████      ███
██                                       ███     █████  ████           ████                  ███████             ███████                    ██████     █████    ████████████                                   █████                                              ████      ███      ███
███                                       █      ████                   ████                  ███████            ███████                    ██████    ███████   ██████████████                                 █████                      ██                      ████      ███      ███
███                               ███                                   ████                    █████            █████                       ████     ███████    ██████████████████    ██     ███         ██  ██████           █          █                       ████     ████      ███
███         ███   ████████        ████                                 █████                ██  ██████           ████                                 ██████          ████████████████████████████       ██████████           ███                   ███            ██      ████      ███
██   ███   ████████████████        ████                              ███████                ███████████           ██                    █        ██    █████           ███   ██████████████████████       █████████          ████                  ████     █               ████     ███
██  ████████████████████████        ████                             ██████                 ████████████                               ███      ████    █████          ███    ██████████████   ████        ████████           ██                    ███    ███                ███    ███
██  ████████████████     ███         ████                            ██████                   ███████████                              ███      █████     ████         ████    ██     █████     ██         ████████                                       ███        ██        ██     ██
██   ████████   ███                   ████                           ███████                   ██████████                               ███     ██████     ████         ████                                ████                                         ████      █████               █
██        ███                          ████                          ███  ██        █           ████████                                 ███     █████      ████        █████                                ██                           █     ███      ███     ████████              █
██         ███       ████               ████                        ███             ██           ██                                      ████      ██       ████        █████                           █                                 ██    ███      ███    ████████               █
███        ████     ██████               ████               █      ████             ██                                          ████     █████               ██         ██████                                                                 ████      ██    █████████               █
███        █████    ████████              ███             ████    ██████             ██                                        ██████    █████               ██          ██████          ███                       ██                          ███       ██    ████████                █
███        ██████   █████████              █           ██████     ██████              ██     ███                               ██████    █████               ██           █████         █████                     ████                                   ███   ████████                █
███        ██████   ████████                           █████       ██████              ██   █████                              ██████    ████                ███           ████         █████                    ████                                    ███    ███████    ████        █
███         ████     ████                     ██       ████          ████               ██  █████            ██                 █████    ███                  █             ███        █████                    ████                                     ████    ██████    ████        █
███                                          ██████                   ████              ██   █████            █                  ████    ███                                 ███       ███                       █                              ██      █████      ████    ███         █
████                           ██            ███████            ██    ████              ██   ██████                               ██                                         █████                                        ███          ███     ████     █████       ████               █
████                          ████            ██████           ████   ████              ██   ███████    █                                                                   ██████               ██                       ███          ███    █████      ███         ███              ██
███                      ██   █████           ███████  ██      ████   █████            ███   ███████                                                                       ███████              ███                       ████          █    █████       ███    ██   ███       ██  █████
███                     ████   ██████   ██     ███████████     ███    ███████         ████   ████████                                          ████                        ██████              ████                       ████                ██               ████  ████     ██████████
██             ██       ████    ████████████      █████████    ███     ███████       ████     ████████                                ██      ██████                       █████               ████                        ████                                ███████████    ██████████
██             ███      █████    ███████████       ███████████████      ██████      █████      █████████                ████        █████     ██████                       ████                ████       ██████    ██      ███                                 ███████████   ██████████
██             ███      ██████   █████              ██  ███████████     ██████     ██████          ██████              ██████      ███████   ████████                     ████                 ████      ████████   ███     ████                 ███             ███████████████████ ███
██             ███       ████████                        ██████████    ██████      ███████          ██████             ██████     █████████  ███████████                 █████                ███████   ████████    ███     ████            ██  █████            ██████████████████   ██
███             ██        ███████                        ██████████   █████         ███████          █████              ████       ████████   ██████████                ██████               ██████████████          █     █████           ██████████             ████████████████    ██
███             ███         █████                         █████████   ████           ███████          ████                               █     █████████               ███████               █████████████                █████            ███████████            ███████████  ██     ██
████            ██████       ███                            ██████    ████              ████                     ███                           ████████               ███████                █████████████   ██          █████   ██        ████████████           ██████████          ██
████            ████████                                      ████    ████              ████                     ███             █             ████                  ████████                 ███████████   ████         ████   ████       █████    ████          ████ █████          ██
███            ██████████                                     █████    ████      ██     ████                     ████           ███      ███  ████                  █████████   ████████         ███████    ████         ███   ████        ████      ████    ██  ████   ████         ███
███            ██████████                                     █████     ████    ███   ██████                     █████          ██      █████████          ██       ████████   ██████████                  █████              ████          ███       ███████████████    ███        ████
████           ███████████    █                              █████       ███    ███  ███████              ██      ████          ██     █████████      ████████      ████████   █████ ████                  █████              ████                   ████████████████              █████
█████          ████████████  ███                            ██████              ███  ███████             ████     ████          ███    ██████       ██████████      ███████     ███   ██                  █████               ████                  ████████████████               █████
██████         ████████████████                         █████  ███              ███   ██████             █████     ██     ███   ███     ███        ████  ████       █████        ██                       ████        ████     ██       ██        ██████████████████       ███     █████
██████         ████████████████      ██                █████    ██              ███     ████             ██████          ████   ████              ████               ███          ██                       ███       █████              ██    █████████  ███████████      █████   ██████
██  ███         █████████  ████   ███████   ███         ██     ███             ███      ████              ██████         ███     ████           ██████               ███          ███                      ███       █████              ██   ████████     █████████      ██████   ██████
█    ███         ███████    ██    ██████████████             █████            ███       ████              ██████         ███      █████       █████████                          ████                      ████     ███                ███   ██████        █  █████     ███████    █████
█    ███           ████           ██████████████            ██████            ███      █████              ████          ████       ████       ███████████       ██              ████                       ████    ███         ███████████    ██               ███      ████████  ██████
█                   ███            █████████████            █████             ███    ██████               ███          ██████      ████       █████   ████     ████            █████     ███████           ███     ██         ████████████                     ██        ██   ██████████
██                  ████           █████████████           █████               █    ███████                           ████████     ████         ██     ███     █████            ████    █████████          ██                 ████████████         █                           █████████
██          █       ███████        ██████████████   █     ██████                     █████                           ██████████     ██                  ██      █████             ███  ███████████        ██                   ██████████         ███                           ████████
██          ██      ████████      ████████████████████    ██████                       ██                           ████████████                                █████              ████████████████      ███                     █████           ███                            ███  ███
███          ██      ███████      ████████    ███████      █████        ████                                       ██████████████                              █████         ██     █████████████████    ███          █████       ███            ███        ██                   █    ██
████          ██       ████      ████████       ████       ████        ██████                          █           ██████████████                            ██████         ████        ███████    ██                ███████      ███             ███       ███  ███                  ██
██████        ███               █████████        ███        ███       ███████                         ██████      ████████████████             ████          █████          ████         ██                           ███████     ███              ███      ██████████                ██
███████       ███             ███████████        ███        ███      ███████                           █████      ███████  ███████████        █████          ████          █████                             ██         █████    ████              ████      ██████████               ██
███████      ████            ███████████          ███      ████      ███████                            ███       ██████    ███████████       █████                       ██████                            ████         █████  █████               ██       █████████           ██  ███
██████       ████            ███  ██████  ██       ██      ███████  ████████         ███                          █████         ██████                                    ████  ████             ███        ████          ███████████     ██             ██ ████  ███          █████████
██████        ███             █    ████  ████       ██      █████████████████       ████                         ██████         █████                                      ██    ████   ███     █████        ██            █████████     ████           ███████               ██████████
██████        ███                   ██  ██████      ██       █████████  ███████      ███                        ██████          ████                                              ██    ████   ███████                     ████████     ██████████      ███████               ██████████
█████████     ███                       ██████     ███        ███████    ██████                      ███       ██████       ███████                        █    ███                      █████████████                                 ████████████      ██████               ████   ███
█████████                               █████     ████          ████      ███                       █████      ███         ████████           █           ███   ███                       ███████████        ███   ███                 █████████████     ███████              ███     ██
██   ███                               █████      ████           ██                           █    ███████     ██         █████████          ███          ███   ███                        ██████           █████  ███           █      ███████████      ███████                      ██
█                                    █████        █████                                      ███  █████████           ████████████           ██           ███                              █████            █████  ███          ███      ████████       ████  █                       ██
█                                   █████         █████                                       █   ██████████         █████████                ██  ██     ████                               ████    ██      █████   ███        ████           ██        ███                          ███
██                               ████████  ██     █████                                           ██████████          ██████                  ███████    █████                              ████   ████    █████    ████     ██████                     ██                           ███
██                              ██████████████     ███                                             ██████ ██          █████                  ████████    ██████                              ██    █████   ████    ███████████████                ██   ███                           ███
███                    ██     ████████████████                  ██                         ██      █████               ████        █        █████████   ███████               ██                   ██████ ████     ███████████████      ████    ██████████                           ███
███                    ██    █████████████████                 ████                      █████     ██████               ██        ███     █████████████████████              ████                  ███████████    ███████████████████████████  ███████████                           ███
███       ██          ████  ██████████████████       ███       ████                    ████████   ████████        ██             █████   ███████████████████████            ██████████            █████████████  █████████████████████████████████████████    ████     ███     ███   ███
████  ███████      ████████████████████████████  ███████████   █████  ██████████      ██████████████████████     █████     █████████████████████████████████████████  ███  █████████████  ███   ███████████████████████████████████████████████████████████  ███████████████████████████
█████████████████████████████████████████████████████████████  █████████████████████████████████████████████████████████████████████████████████████████████████████████████████████████████████████████████████████████████████████████████████████████████████████████████████████████
