████████████████████████████████████████████████████████████████████████████████████████████████████████████████████████████████████████████████████████████████████████████████████████████████████████████████████████████████████████████████████████████████████████████████████████
██████████████████  ███████████████████████████████████████████████████████████████████████████████████████  ████  ████  ████████████████████████████████  ███████████████████████████  ████████████████████████████  █████████████████████████████████████████  ███████████████████████
████   ██████████    ██  █████████████          ████████    ███     █████████          ███████████████████                          ████████████████             ████████████   █████    ███    ██████████████          ████    ██████████       ██████████ ██      █████████████   ████
███     █████████         ███████████            ██████              █████              ██████████████████                          ████████████                   █████████                     █████████████                      █████         ████████            ████████       ███
███    █      ███         ██████  ██             █████                ███                ████████████████             ██████         ██████████                          ███                     ███████ ██████                       ██          ████████             ██████         ██
███   ██       ███       ██████                  ████                                    ████  ████████              ████████           ███████                           ██                    ███████   ██████                                 ██████████            █████          ██
███   ███      ████     ██████                    ██                                      ██    ██████              █████████            ██████                           ██                  █████████    ██████      ████                     ████████████           ████          ███
██     ███     ████     █████                                                                       ██             ██████████             █████                            ██                █████  ██      ████████  ███████                  ████████████████        ████         ████
██      ███     ███      ███                               ██                                       ███           ██████████              █████                    ███     ██                ████            ██████████████████        ███     ██████   ████████       ████        █████
███     ████             ███                              ████                   ██                 ████    ██    █████████               █████                    ████   ████              █████                ██████████████       ████     █████     █████████     ████        █████
████    █████             █                    ████       ████                  ████                ████   ████    ██  ████                █████          ██        ███████████             ██████                ████████            ███      ████          ██████    █████       █████
████     ████                                 ██████       ██                  ██████                ██    ████         ███                █████         ███        ████████████             ██████     ██         ██████              █        ██            ████     █████        ████
████      ████        ███                    ███████████           ███       ████████                     ████                              ███      ██████         ██████████████             ████████████        █████                                                ███          ███
████       ███       █████          █       ██████████████         ████     █████████      ███████         ██                                        █████          ███████████████  ██        ████████████        ████                                                        █     ███
███        ███       █████         ███     ████████████████        ██████    ████████     █████████                                                  ████            ███████████████████  ██████████████████       ███                                                        ███    ███
███        ███        ███      █    █      ██████████████████       ██████      ██████   ███████████                 █████                                            █████████   ██████████████████████████       ███                                  ███                  █████  ████
██   ██   ████              █████           █████████  ████████       ████       █████████████████████             ████████                                           ████████     ████████████████████████       █████                               ██████              ██████████████
███ █████████               ████             ████       ███████        ███         ████████████████████     █████████  █████                                           ██████         ████████████████████        █████                ███            █████              ███████████████
████████████                ███              ███        ███████         ██           ██████████████████    █████████     ██                    ██                      █████    ██        ████████████████         ███                 ████             ██               ███████████████
████████████                                  ██        ██████          ██            ██████      ████    ██████                              ████                      ███    ████        █████  ███████                ██            ████                              █████████  ████
████████████                                  ██         ████           ██             ████        ███    █████                               ████                             █████       ████    ██████               ███            ████   ███                        ████████    ███
███████████                                   ██                       ███                         ███     ███                                ████                              ████       ███      ████               ███              ███   ████                       █████       ███
████████                                      ██                   ███████                         ████    ███    ████                         ███                                █     ██████       ██          ██   ███               ███   ████                  █     ██          ██
███████                                        ██  ███             ████████                       ██████  ████   ██████                        ███                ██                   ████████                 ████████                ████ █████                 ███                ██
██████                                  ███     ███████     ████    ███████                      █████████████   ███████                       ███               ███     █████       ███████████                ███████                 ██████████                 ███                ██
█████                                   ████    ███████    ██████    █████             ███       █████████████   ████████                      ████       ██      ██     █████      █████████████                ██████                 ███████████                 █                ███
███                                      ██████   █████    ██████    ████             █████         ██████████   █████████              ████    ████     ████     ██     ██        ██████   ██████                 ████                  ███████████                                ████
██                              ███        █████   ███    ██████      ██              █████           ████████   ████████              ██████    ███     ████      ██              ██████    ██████           ██    ██                    ██████████                                ████
█                              ████         ████          █████                       ████                 ██    █████                ████████    ██      ████     ██              ██████    ██████           ███                          ████████                                 ████
█                              ████                       █████                       ████                       █████                █████████            ████    ███              ████    ████████          ████                         ███████                                 █████
██                              ██                         ████                       ████    ██                  █████               ██████████            ███    ████  ██          ██   ██████████          ████                        ███████               ██                 █████
██                              ██                         █████     █                █████   ███                   ████               ██████████                  █████████             ███████████      ██   ██        ██               ██████             ██████                 ████
██                    ██        ███   ██████               ████████████                ████   ██████                 ███               ███████████                  ███████             ████   █████                    ███                █████     █      ████████        ███      ███
███      ██          ████        █████████████            ████████████                  ██     ██████    ███         ██    ██          ████████████                    ████     ██     ███      ███                     ███                 ████    ███    █████████       █████     ███
████   █████         █████        █████   █████           ██  ███████                          ██████    ████       ██    ██████       █████████████                   ████    ████    ██                               ███                  ████   ████  ██████████      ██████      ██
█████████████         ████                  █████              █████                            █████    █████      ██    ███████      ████████████                    █████████████  ███                               ███                  ████    ██████████████       █████       ██
██████████████                                 ████             ███            ███                ██      ██████           ██████      ███████████                    ███████████████████                                ███                 ████     ████████            ████       ███
████████████████                        ███     ████                           ███                        ███████           ████        █████████                    ███████████████████                                 ████  ██             ██       ██  ██              ██        ███
█████████████████                      ██████    ████                                                     ███████                        ████████                    ███████    ████                               ███  ██████████                                                  ████
█████████    █████             ██      ██████    █████                                                     █████                          ██   █                     ██████      ██                               ████████████████                                    ███          █████
████████      █████                     █████    █████                                                                            ███                                   ███             █                         ███████████   ██                                    ███         ██████
███████       ██████                             █████                                                                           █████                         ███       █             ███                       ███████████            ███                          ████     █   ██████
██████        ███████                            █████                      ███                                                  ██████    ██                  ████              ██    ███                  ███████████████            █████      ██                █████    ██   ██████
█████        █████████                            ████          ██         █████████                                              ██████   ███                 █████             ███    ██                 ████████████████       ██    ████     ████            █████████    █    █████
████         █████████                   ██       ████         ███        ██████████                                              ██████   ███                  ████             ███                       ████████████████       ██    ████     ████           ██████████            ██
████        █████████                   ████       ██         ███         ██████████                                             ██████                         █████            ███                       ██████████████████           ████     ████           ██████████             █
█████       ████████                   █████                  ███         ██████████                   ██                        █████                          █████                                      ███████████████████         █████      ██      ███    █████████        ██  ██
██████      ████████         ███       ████     ███           ███          █████████                 █████                       ████                          █████                   ██████              ████   █████████████        █████              ███           ██     █████████
██████      ███████         █████       █      ██████          ███         ██████████               ██████                        ███                       █████                     ████████     ███     ███        ████████          ███                                   ██████████
███████      ████          ██████              ███████         ██████████   ██████████              ██████                        ███           ███        █████        █              ███████    █████     ██            ███                                                 ██████████
█   ████                  ██████                █████████       ██████████   █████  ██                                            ███          █████    ███████        ███               ████    ███████    ███                                                               ██████████
█    ████                 █████                   ████████        █████████ █████                                                 ███         ██████    ██             ████               ██    █████████   █████                                                              █████████
█    █████                ████          ███         ██████         █████████████                                             ███  ███         ██████                   ████         ██          █████████   ██████                                     ██                ██         ████
█    █████                              ████         ██████         ████████████                                      ██      █    ███         █████                   ████        ████         ████████     ██████                █                  ███████          █████         ███
██  ██████                               ███          ████████      ████████████                           ██         ██           ██████       ████                   ████       █████         ████████     ██████               ███                 ███████         ███████         ██
███████████                               ███         █████████      ████████████                       █████                      ███████       ██          █         █████     █████          ████████      █████               ██                   ███████       █████████        ██
████████████      █                       ███         █████████       ████████████                    ███████                       █████             █████████       ██████    ████     █       ████████      ████               ██       ██   ██         ████      █████████        ██
█████████  █     ███             █       ████        ██████████       █████████████                  ████████                                         ████████        █████     ███     ██          █████       ██       ███     █        █████████         ███      ██████████      ███
████████         ███            ███      ███         ██████████        ███████████ █                 ███████                 ██                        ███             ███      ████  ███            ████              ██████   ██        █████████          ██     ████████ ███    ████
██   ██           ██            ███       ██          ████             █████████   ██                 ██          ███      ████                                                 ████████          █  ████             ███████             █████████                  ██       ███  █████
██                              ███       ███                           ████████   ███    ███                     ████     ██                                                   ████████         ███████              ██████               ███████                           ███████████
███                            ████       ███████                           ████   ███    ████                    ████                                 █                        ████████          ██████    ██        ███                   ████                           █████████████
███            ████          ██████      ████████                            ██   █████  █████                   █████                                ███                       ████████           █████   ████                       █      ██                           ██████████████
████          ██████        ███████     █████████                                 ███████████              █     █████                                ███       ████             ████████           █████ █████                      ███                                 ██████████ ████
████████████████████       █████████    █████████   ███     ███        ██        ████████████                     █████  █████                       ███     ████████            █████████          ████████████          ██         ███     ██                        ██████        ███
█████████████████████  ██████████████  █████████████████   █████  ██  ████      █████████████  ██                 █████████████       ███████████   ████    █████████████      █████████████████   ██████████████   █████████       ████    ███████   ███            ████████       ████
███████████████████████████████████████████████████████████████████████████████████████████████████               ███████████████████████████████████████  ██████████████████████████████████████████████████████████████████████████████  █████████████████████   ████████████   ██████
████████████████████████████████████████████████████████████████████████████████████████████████████████████████████████████████████████████████████████████████████████████████████████████████████████████████████████████████████████████████████████████████████████████████████████
