████████████████████████████████████████████████████████████████████████████████████████████████████████████████████████████████████████████████████████████████████████████████████████████████████████████████████████████████████████████████████████████████████████████████████████
█ ███  █████  ███████       █  ████     ██ █ █ █ █ █  █ █ ██    █ █  █  ███████   █   █  █ █  ██ ██ ██   █ ██ █   █ █ ██   █ ███ █  █  █   ██   ██  █ █ ████  ████    ██  ██      ██    ███ █    █ █     █  █      █   ██   █  █    █████ █  ███ █     █ █ █ ██       ██     █  █ ████ █
█   █  █         ████  ██  █ █ ██         █████     ████ ██ █    █  █ █  █   ███ █ █     ██ ████    ████ ██  ███    █  ██    ███████ █ █       ██ ██ █ ██████ ███ █ █ █ ██ ██          █   █  ██ █  ██  █   ██ █ ████ ███ ██ ████  ███ ██    ███ ████   █   ██     ██ ██ █   █   █  ████
█ ██  █ ██    ███████████ █    ██ ██   █ ██ █  ██ █  █  █  ███   ██  ███ ████ █ █████  ██  █ █ █  █ █████████ ██ █ ██████ █    ███ █    ███ ███ ██     █ █           ██           ██    █ █      █     ███ ██    █ ██████    █      ███   █ █  ██ █ ████   █ █  █  █   █████  ██ █ ██ ██
█  ██  ███   █ █  █ █    ████   █ █ █ ███  █   █ █ ██ █  ███ ██   ██████ ██ ██ ██ █   █ ██ ████ █ ██    ██    █ ████ ██ █  ██  ██ ██ █ █ ████ ██  ██ █ ██ █ █       █  ███  █████  ███   █       ███  ███  ██  ██ ██   ███   ███  ██   ███ █   ███ █ ██     █       ███ ███   ██  █ █  █
█ ██ █ █ █ ██    █  ██    ██ ███  ███ █  █   █  ██ █  █ █    ███ █  █  ██ █ ██ █   ███ █ ██     █ █ ███  █ █  █ █████   █ █   ██ █ █  █         ██ █ █   █   ██ █ █████    █  █ ████   ██   ██    █ █ ███ █ █   ███  ██   ██████  ██ █ █ █ ████ ███ ██ ██ ██    ████ ███  ██   █████ █ █
█  █ ████████ ██  █ █ ██  ██ █   ██   █ ███   ██   █ █ █   █ ██     █        ██     ████ ██       ██ ██ █ ██  ██ ██  ██  ███   ██   █ █    █   ███ ██   █ █   █ ██  █ █    █ █  █ █   ███   █   ███  █  █   █ █ ████   ██       ██   ██████  █ ██  █   ███   ██ ███   ██   ██    ██ █ ██
████     ████    ██        █  ███ █  ██ █       █    █   █ █ █ █    ██  █  █ █     █ █ █ █ █ ██  ██       █ ██  ██ █   █    ██    ███ █  ██  █  █ █ █ █   ██████ █ █ █ ██ ██     █ ██ ██  ██     ███    █   █         ██     ███     ███       █   █████    ███  ██  ██ █ ██  █    ██ ██
███  ███ ██         █ ██ █  █    ██      █ ██      ██  ███  ████  █    █       █ █      █  ███ █ █    █    ██   █    ███    █ ████ ██ █    ██         ████  █  █ ██   ██ █  █  █  ██  ████   ██    █ ██   ██ █     █ █   ██ ██ █    ███  █ ██   █  █ ██ █   █ ██    █ ███ ███      █ █ █
█     █ █ ██ ██ ████ █ █ █    ██  █   █  █  █ █  ██████  █    ████        ██ █ █    ██████ ██      █     █   ███ █ ██      ██        ██  █ ████  █ █   █ ██    █ █        █████   ██ ██  ██ █  ██    █  ██   █     ███ █ █    █       █ █ ██ ███  █ █ ██      ██     ██      █     █████
█ ██ █     █  █   ██  ██    █    █ ██ ██    ██       █  █  ███   █  ██ █  ██   █  █  ███ ██   █    █ █ ██ █  █ ███      ███    ███    █   ███ █ █    ██  █    ██  ████ █ ██ █  █ ██ █ █ █  █  ██    █████ █   ██  ███ █  █  █ ███ ███ ██████  █ █ █ █ █  █████████  █ ████  ██  ██     █
█ █   █  █   ██   █  █ █    █ ███ ██  █ █  ██   ██      ██  █ █   ███    ██   ██ ██    ██   ██ ██  █   █ █     ██ █   ██  █   █ ██  █ █ █    ██  █  ██   █████         ███  █ █ █    ██ █   █ █ ██ ██  ███ █  ████  ████ ███ █  █ █ █ ██ █ █ ██  ███        ██ █     █  ██  ██ █  ████ █
██    █ ██ █████  █  ███    █ ███ ██   ██ █ █  █ █ █ ████ █        ███████ ███ █ █ █ ██  █ █    █  ██ █         █     ██   ██ ██ ██     ██  ██        █ ██ ██  ███   ██ ██  █ ████  █ █  █   ██  █ ███  █ █  █   ██   ██████  █ █   █  ██   ███ █ █  █ ████  █ █ █     ██  █          ██
█ █████ ██  █ █  ███   █   █    █ █ █ ███  █    █  ████ █████   ████ █  █ █ ██ █  █   █ █  █  ███    █    █  ██ █  █   ███  ██ ██ █  █ █  █    █ █ █   █ █ █ ███ █  ██ █ █    ██ █ █  █ █████ █   ██ █   █  █ █ █ ██ █ █  █ █ █    ██ █ ██    ███ █    ██ █ ███   █ █ █  ███  ██  █ █ ██
█  ██ █   █ ████  █ █ ██   █   █   █  █ ███  █  ███ ███     █    █████ ████ ██ ████   █ █████ █ ███ █ █  █ ██████ █ ██    ██    █  █  █ █ ███ ██  █   █ ███  █ ██ ██ ██    █████████ █  █  ████  █  █     █ ██   █ ██  ██ ███      ██  ███ █   █ █████   ███ █  ██ ██  █   ██ █ ██    ██
█ █  ████ ██ ██ ██████████   ██ █   █       █  █ █    █ █  ██   █████  █   ███ █████    ██    █ █  █ █      ██  █ █     ██   ██  ██         █    █ ████ █    █ ██ ██ ██ █ █  █ █  █ █ █   █    █ █ ██   ██     █ ██  ████ ██    █   ████ ███ ██  █   █  ███████ ██ █ ███     █  █ ██ █ █
█ █ █  ███ █ ██ █ █ █ █ █ ██    █ █ ██     ██ █ █ █ ██  █  █ █  █ ██   ███ ███  █ █   █ ████     █ █   █  ██    █ █         █████ █     █     █ █ ███  █          █ █    █ ██ ██ █ █ ██████  █ █   ██ ████      ███    ███ ███  ██ ████      ██    ███ ███ █ ███████ █   ███ █        ██
█  █   █   █ █   ███ ██ █ █   ██ ██ ██ █  █   █    ██   █ █  ██ █  █  ███ █ █████  ██     █ ██    █  ██   █ ███ ██   █   ██████ █      ██  ████ █    ██    ██  █    ███ █ ██  █ █ █████ █    █  █ ██ █ ████  █████ █ ██  ████   ██████ █  █ █  █ █          █ ████  ██ █ █    ███ ███  █
█      █ █  █  ███ █ ██  █  ██     █████ █  ██ █   █  ██ ██████  ██ ████  █  ████ █    █ ██   █ █     █ █ ████ █ ██ █ ██  █ ███ █ █ █ █ █  █ █    █  █ ███ ██ █  █ ████ █ █   ███ █     █ █ █   █ █     ██ ███ ███   ███ █ █ █ █ █  █   ██  █       █ █ █   █ ████  █████  █ █    █  █ █
███  █ █ ██ ██       █ █   █  █ ████ ███     █  ████   █  ███ ██ ███    █ █ ██ █  █  █  ██  ██ ██    ██  ██  █  █     ███ █    ██ █ █   ███ █ █  ██  █████   ████ █ ██████ ███ ███ █ █ █  █  ███   █   ██    █   █   █ █     █ █  ██████ █  ██ ███  █     █ █ █ ██    █  █  █ █ ███   ██
█ █ █ █ ███    █ █ █  ██  ██  █ ██  ███████  █ █ ██   █ █        ████ █      █ ███  █ █ █  █  ██ █  █ █    █ █  █ █ █    █ █ █ █ █   █ ██  ██  ██ ██  █  █ █    █   █ █  ██████   ██    █  █  ██ ██    █  ███    ██   █     ████ █  █  ███    █  █     █  █   ██ █  ███   █ ██    ██ ███
█  █   █ █ ██          █     █   █   █ █  █ █ ██         █ █    █  █    ███        ██  █   █  ███ ███   █   ████ ██ ████ ███ █ ██   █  █ ██   █  █   ██ █  ████ █ █   █ ██   █     █████  ██ █ █  █    █ █ █  ███     █████     █ █ █ █ █  █  █   ██ █   █ █  █ █ █ █ ████ █ █  ████  ██
█ ██   ██   ██ █ █ ███ ██     █  █  █           █     ████ ██  ███ ██ ███     ██   █  ██   ██   █   █ ██ ██   ██████ █  █     █  █   █  █ ████ ██    ██ █  █ █ ███   █ ██ █ █ ██  ██ █ █  █  ███  ███  ██   ██ ██  █ █  █   ███████ █ █   █     ████████ ██ █ █ █ █  ████  █████   █  ██
█  ███ █  █     ██  █ ██████   █    █  █   ██  █ █ ██  ██ ██    █   ██ █ ██   █ ████ █ ██  █ █ █ █████ ██  ██   █  █ █ ██ █ █       █    ██    █  ██  █      █ █    █   ███ █ ███ █       █ █  █    ████  █  █  █            ██ ██████  █ █ █ ██ ████    █ █ ██  ████   █  █  █ █   █  █
█  █   ██   █         ██  ██ ████   ██ █    ███ ███   █ █  █ █ █ ███     ██ ███  ███  ██  █ ██████   ███   ████ █ █ ███  ███████  █   ██  █    █    █████ █ ██ █████   █   █        █  █    █     █████      █  █   ██     █ █   ██ █  █   ███   ██    ███   █   █  █ █   █ █████    █ █
█  █ █ ████ ████  █ █ █        █ ██ ██ █  ██    █ █ █   ███     █ █ ████ ██     █  █ ████ ██     █   █ ██   █        █     █  ███ █ ██   █  ███ █  ███ █  ████    ██   ████   ██       █ ██  █ █ ██ █ ███    █ █ █ █    █        ██     █ █  ██ █   ██ ███████     █  ██  ███ ███ ██████
█   ████  █  ██  ███ ██  ██ █████████████    █  █  █ █ █  █  █        ██  ██     ██████   ██      █   █     ██   ███    █ ██  █████ █ █  ████   █ █  █   █  █  ██    █ █  █ ███ █ █     █  █  █ ███      ██ █ █ ███  ██ ████  █ ██  ██   ██ ██     █   █ ██    █   ████      █  █ ██ █ █
█ █  ██  ██  ████  █  █        ██ █ █ ██  ███ █  █    ██  ██      █ █ █ █ █ ██   ███    ██ █   ██ █ █ ██  █████  ████ █████ █ ██   █ █   █ ███ █  █ ██     █ ██  ██  ██  █    ██   █  █ ████ █ █      █    ████ ██  ██  █   █   █    █   █  █ ███ █ ███  ██   ███ █      █  ███      ███
█  █ █  █   ███ █ █    ████  ██ ██  █   █   ██    ██████    █ ████ ███    ███    ███   ██ ███ █ █    █ ███  ██ █  ███  ██          ███ ████ ██   █ ██    █     █ █  ██  █  ██ ██ ██████ █ ███ ██  █ █ █   █       ██ █   █ █ ███ █  █    ██    █████  █  ███ ██ █ █      ██  █ ███ █  ██
███ █  █   █ █     ██   █ █ ███  ████ ██  ██  █     █ ██    █  ███  █   █████ █     █   ██     █  ██ ██  ███  █  ████ █    █  ██    ██   █  █  █ ███ █   █ █ ███   ██   █ █ █  █ █  █   ███ ████  ███ █   █ ██  ██ ██ █    █   ██  ██  █ █  █ █  █    █ █ █  ██  █ ██ ██ ███ █  ████   █
███  █        █████      ████ ██  ████   ███  █  ███    █ █  █ ██████ ██    █ ██  ██  █  ████ █  █   █ █ ██ ███  ██ ██        ██████ ███ █ █   █ █ ██ ██ ██ █ ████ █   █     █ ██  █ █   ██  ██  ███ ██ █   ██ █ ███   █   ███   ██   █  █   ██  █ ██ ██ █  ██ ██ ██ ███  ██ ██ █    ███
█ ██      █ █ █ ████ █ █ █  ██  █ ██   ██   █  █  █ ██    ██ ██   ██████ █ █  █ ██     █ █  █       ██  ███ ██       ██ ███  █████ █  █   █      ████  █    █ ███ █  ██   █  ██   █████     ██ ██ █  █ ██ █ █ █  █ █ ██ █   █ █ █ █     ██ ██████ ███     █ ██       █  █   █      █   █
█  █ █ ███   █ █ ███ █ █   ██  █ ██  ██ ██       ██  █  █ ██   █ █ █████   ██   █ ██   ██   █ █  █ █  ████  ███  █ ███  ██  ██  ████  █    █ ███ ██ ███  ██ █ █  █ █   ████   ██ █ ███    █  ████  ██   █    █   ██       ███   █  █ ███   ██████  ██   █████ █  █ █     █ █ ██ █  █   █
█ █ █  ███  █ ██ █ █ █  ██ █    ███ ██ ██   ██ ████ █  █     █  █ ██  ██ █   ████ ██     ██   ██ ██    ██  █ █  █  ████ ██      █      ██   █ █  █     █  ███████████      █ █  █ █     ██ ███ ██ █  █ █  ██   ███  █     █  ███  █ █     █  █   █ ████   ██      █   ███      ███  █ ██
█ ██  █     █  █ ██ █ █     █ ██        █  █ █ █ ████ ███████  █ ██   ███ ██ █  █ ██   ██ █ ██ █ █    ███        █ ███ █ ██ █      █  ███  █       ████ █ █  ███      ██   █   █ █ █ ███    ███  █ █ █    ███  ██   █    █    █ █  █     ██████  ███  ██ ██    ██ ██  █   ██ █    █ █ ██
██   █ ██ █     █ █ █  ███ █       █ █  ███ █  █   █ █ ██     ████   █      ██   ██  ██  █  ██████ █   ████  █ ██  ███   █ █      ███   █  ██ █ ███ █ █   █ ███ ██  █    ██ █   ███    █  ██   █████ █     █  █ █  █  █  █ █    ███ █  █     ██ ██ ██     █ █  █ ███ ███  ██    █ █   ██
█   ███     █ █   █ █  █ █   █    ██  ██    █ █ ███ █ ██     █ █    █████████ ██  ██ █ ██  █ █ █   ████  █ ██  ██ █ █████  ██  ████  ██   █   █   █   █       █ █  █   █ █    ██   █   █ █   █  ██ ██ ██  █ █████ █  █   █   █ █  ██ █      ██  ███  █   ██  █   █  █ ██████ ██       ██
██ █ █  █     ██   █  █     █ ████   ██    █ █ ██    █  █            ██    █  ██   ██ ███    ██ █ █ ██   ███ █    █    ██  █ ██ ██  █ █   █  ███ ███   ████  █ █       █    ████  ██ ██  ███ █ ████    ██      █  ███  ███   █ █     ██      █ █  █ █  ███  █████  █  ██ ██  █ ██    ███
█ ███    █      ██ █ ███████ ████ █████      ██ ███ █ ████  █ █  ██████ █   █ ████ █ ████  ███   ██  █   ██   █████   █████    █ ██  █ ██  █    █ █  ███  █   █ ██    █ █   █ █  ███ ██      █ █   ██          █  ██     █ █ █ ████   █████ █ ██  ████ ██  █  █ ██  █    █  ████ ██   ██
██       █  █    ███ ██  ██  █ ███ █  ████ █  █   █ ██  █ █  ██   █ █  █ █ █  █ █ █  ███ █ █   ██  █ █ █ █████ ██  ██ █ █ ██  ███ █ █ ███ █ █ █ █  ███  ███ ██ █ █ ███    ██ ██ █ █ █████   █ ██  █   ███  █ █  ██     ███   █  █ ████  █ █ ██  ███  █ █  █  █   █ █ █ █  ███ ██     █ █
██ █ █ █ ████  ██ ███   ███ █  ████    █  █  ████  ██  █ █   ██ ██  █  █  ████  █ █  ██    ██      ██ █ ████ █ █   ████ █████        ███ █  ██ ███ █    █  ██ █   █ █   ██      █  █  █ █ ███    █    █    ██ ██   ██     ██ █  █   █ █        █ █ ███ █ ██████  ████   █ █ █ █ █    ███
██ █ ████████ █  ██████ ███████      ███ █ █ █ ██    █ ███     █    ████  █  ███    █  ███ █    ███  ████ █████   █ █ █ ███    █  █ ███ ██     █ █  ██   █ ██ █   █  █ █    ██ ██  █ █ ███  █████████  ███ ████   █ █ ██   █ █ ██    █ ██████    █ █   █  █  ██       █ ███   █ █ ██████
█  █ █     █  ███ █ ██ ████          ██   ███    ██  █  █ █ █ █            █  ██ █ █  ██ █ ██  █████ █ █ █  █ ██████ ██ █      █ ██  █  ███ █ █ █   ██ ██  █ █   █████ ██  █  ███       █  █  █  ███   █   █     █   █ ███     ███ █ █ ██ ██████ █ █  █  █       █    █ ██ ████    █   █
█ █  ███████       █ ████ █ ██ █  █ █ ██  █      ███████  ██   ████ █  █ █   █ █   █ █ ██   █  ███ ██  █  ██ ████  █ █  ████    █  ██  █ █    █ █  ██   ██  █ █ ██     █ ██    █  █   █       █   ██ ██  █  █ █ ██   █████ █ █ █  ██  █ █ ██     █   █  ██         ███  █   █   ██  ████
████ ███   ██     █   ██  ██ █████ █ █ ████ █   ██ ██████   ███ ███  █ ██ █ ████ █  █ ██ █ █   ███ ███ █   █ █ █ ████  █ █ ███ ██   █ █      █  ███ ███    █ ███   ██        █     █  █    █ ███████ █ ██  █   ██    ██   ██ █    █ █     ██ █  █ █ █  ██ ██   █ ███  ████ █ ██       ██
█  ██ ███ █ ██ █  ██   █   ██ ██  ████     █  ██    █████ █   ████ ████ █ ███ ██ █  █  █ █  █  ██  █ █ ████   █     █ █████   █  █  █ █   █        █ ██        █ ██ █ ███  ███  ██  █   █  ██ ███ █     ███ █ █   ███ █  █  █████   ██    █    █    ██ ████      ██   ███  ██ █ ██ ██  █
█   ██ █ █  █  ██       █    ██   █  █ █ ███ ██ ██ █ █  ██        █ ██  █  █   █   ██████    ██   ████  ███ ████████ ██     █ █  █ █ █    █ █       █ █ █  ███  █      █ █  ███ █ █  █   ███ ███     █                 ██    █ █ ██ ██   █ ███  █  ███  █  ███   █████  █████ ███   █  █
█  ████ █   █ █     █ █  █ █  ██ █ ████  █      ██ ██ █ █ █  ███ ███    ████   ████ █████ █████   ██  ███    █████  ██   ██  ██ ██ █ ██ █   ██ █  █  █    █  ███ ███ █  █  █████ ██      █ █  █  █ ██ ███ ███ ██ █   ██████  ██ █    ████ ██ ██  ██  █  █ ██  ███ ████ ██ ██       █   █
█████  █  █ ██████   █    █  ██████ █ ██ ██ █ █████   ███  ███  █ █  █  █  █ ██   █   ██ ████ █   ███     █    █ ███ ██  █  ████          █  █  ██  █ █   █  ██ █  ███    ██   █ █ █   █ ██    █   █████  ██ ███ █ ██           █ ████    █ █ ████ ███  ██  █ █  █    ██ █   █ ██ ██ ███
█ ███   █ █ ██ █  █  █   ███ █ █ ███      █ █   █ ██ █ ██ █ █  ██  █ █  █   █ ██  █ ██      █  ███ █    █ █ █ █   ████ █     █████ ███     ██ █  █  █ ████ █ █ ███         █  █ █ █████    ███   █    ██ █ ████ █    █ ███   █ █  █ █   ██  █     ██   █████    █  ██  ██   █   █   █  █
████ █ ███  █  █████   ██  ████ █ █     ███  █████ █ █  ██      ██ ███   █     █ █ █  █   █   █████  ████  █    █ █  █   █  ███ ██ ██    █     █ ███ ██    █  █ █  █ █████  ████ ██   █  █  █    ██  ██ ███ █ █    ██     █ ███   █  ██   ███ ████████ ██ ██ ███ ██   ██  █   █ ██ █ █ █
█     █ █  █  █   ██ ██   █ ██  █  ████ ██ ██   ██ ███  ██   █  ██   █   ██   ██      █ █   █    ██   ██ █ ██  ███  ██   █ ██  ██ ██ █  █ █ █ █ ██    █ ██         ███ █████      █████  █ █  █ ██████     ████ ██ █ █ █    ██ █ ██    ████████████    █ ██ █ █  ██ █ █ ███ ██   ██   ██
█  █████  ██  █ ███      ██ ██████ █  ███  █   █ █  ██ █ █       ██  ██ █ ██  █  ███    █   █   █  █  █ █████  ████ █ ██   █  ███ █ █ █   ███ ██  ██ █ █   █      ██ ███ █   █  ████ █ ██████        █████ ████████  ██ ██  ████   ██ █  ██  ██       ███ █  ███  █ █ ██ ██   █    █  ██
█        ███    █  ██ █  ██  █    ██ █  █ ██  █        █   █ █████  █  ██    █  ██    ██ ████    ███████     █    ███   █ ██ ██  █  ████    █  █ █     █  █ █    █ ██  █  ███ ██ ████ █ █ █   █  ███     █ █ █ ███ █  ██    ███ ██ ██   ████  ███  █ ██  ██ █  ██████ █       ███   █  █
█ ██ █ ███   █  ██     ███ █   █      █ █ ██ █    █  █ █ █████ █    █  █  ███     ██  ██ ███  █ ██ ██     █ █ █    ███ ███   █████████ █  █ ██   █  ███ ██ ██    █  ███   ██   █   ██  █ ██  █ ██ █ ████   ██ ██    ██ ███ ██    █      █ ██ █████ █ ██   ████ █       █  █ █ █ ██  █  █
██ █ █ █ █ █ █   ██    █ █    █████ █   ██  █   █     █  █    █████   █ █        █ █  █ ███ █ ██  ██ █  █  ██ ██  █ ██   █████ █  █      ███ ███  ██ █ █   █  █  ███ ██   █  █  ██ ██    █    █   █    █      ██  █ █ █ ██  █ ████ █    █ █ █      ██████  █  █    █ █ █    ██     ███ █
█  ███       ██ ██  █  ████ █    █ ██   ███████      ██    █████  █   ██ ████     ██ █   █ █ █ ████ ██ █  ██  █  ██ █  ██      █ █ █ █ ███  █████ ██████  █ █ ██      ████ █ ██ █ ██ ██  █         █ ████  █  ███ ██      █ █   █  █ █  █ █  ██ ████████ █ ██  ██   █ █       ███  █ █ █
█ ██ █ ████  ██  █ ██ █ █ ██ ██  ██  ██ █  █ ██    █   ███     █ █ █ █  █  █ █████     █  ██  █    ███ █  █     █ ██ ██     █ █ █  █  ██  █    █ ██   ██ █    ███ █   ██   ████   ████    ██ █ █  █    █ █   █ ██ ██ █   █ ██   █  █ █ █ ███████      █ ██ ██      █     █ █  ██    ██ █
███   ████       █ ███   ██ █        ██   █ █████ ██ █    ████     █         █   ██     █ █ ██  █ ██   ██████  ██ ██  ████    █   ██     █   ███ █      █   █████        ██  ██ █   █ █ ██ ███ ████   █   █  █ █   █ ██ █  █  ████ █  █   █     ██   █  ███  █  █████    ███ ███ █    ██
█ █   █ █ █  █  █ █ ██ ██       █      █   █  ██    ██ ██ ██ █ ██ █  █     ██ █ ██  ██████ ██    ██  ███ ███ ████  █ ███  ██   █  █ ███  █  ███ █ ██ ██████ ██    ████ █     █ █    █  ███ █████ ██████ █      ████ █ █ ██ █    ████   ████   ███   █ █   █ █     █  █   ██  ███  ████ █
█ ██ ██   █ █ █████  █   ██ █ ██    ██ ██  ███   ███ ███  ██   ██ ██ █ ██   █    █  ██  ████ ████ ██ ███████   █  ██ █ █ ██   █ ████████        ██  █     ███    █ ████ █  █ █   ██ ██ █   ██  ██  █   █ █  ████ █████  ██  ██ ███  █ ███  █  ██    █ █  █ █   █ ███  █ █  █ ████ █ ████
█   ████  ████    ███ █ █  █  ███   █    █  █  ██     ██     ██    █  █     ██    ██    ██ █       ██ █ █  ██  █ █     █ █ █ █     █ █    ██  ██  ██  █ ██ █   █ ███ █    ██  █ █ ██ ██ █ █ █ █  ██ ██ ██  █   ████ ███ ███████ █  █  █ █    ██     ████ ███ █  █   █  ██  ███    █ █  █
█     █ ██ █ █  ██ ██ ███████ █ █████ █  █ ████ ██    ███ █ ██   ██  █████     ██  ██  █ █    █  █  █  █     ██   ██      █  █ █  ███  ██  █  █ ███  █   ██ █    ██ █  ████ ██ ████     █    █   █ ██   ██ ███ ███  ███ ████  █ ██ ██ ███   █    █    █ █    ██   █     █  ████  █ █ ███
████ ██ █  █   █  █ █ █  ██  █ █ █████ ██  █     █ ███  ███ ██  █ ███    █████  █  █   █    ██ █ ███   ██   █ ███ ██     ███       ███ ██ █ █ ███  ██     █ █  █ ███     █  █  ██ █    ██  ████    █ ███ █ ████          █            █ █  █    █  █ ███      █ █  █ ██     ██   ██  █ █
█  ███   █   ██ █ █  █  █████████      █ █  █  █ █  █  █ ███ █ ████    ██ █   █   █ ██    ██ █████ █ █    █ ██    █   █   █    █  █ ██ █ █  █  █ ██ █   █ ██  ██  ██   ████       █ ██ ████  ███ █   ███ █  █    ███████ ██  ██    █   █     ████   █  ███   █        ███    █ ███ █████
█████       ███    ██    █  ██ █ █ ████ █    ██ █ █      █ ██ █  █ █    █ ██ ██ █ ██ █ ████ ███ ██   █ █ ███ █     █    ██ █ ██ ███   ██  ████    ██  █     ██   █ █  ██  █  ██   █  █   █ █   █ ███ █  █ ████ █ ██    █    ██ █ █ █  █  █    ███    ██ ██    █ █ █  ██ █  █      ████ █
███ █ █████ ██ ██ █  ██ ██  ████   ███     █  █  █ █ █ █     ██ █   ███ ██  ██████  █ ███ █   █ █  █ ██ ███ ██ ████ █   █ █ ██ █  █████ ████ ████  █   ██ ██  ████   █  █    █ ██   █  ██   ██  ███ ██    █  ████ ███  █    █  █  █ █   ████ ███ █ ███   ██  ████████████    █   █ █████
████████████████████████████████████████████████████████████████████████████████████████████████████████████████████████████████████████████████████████████████████████████████████████████████████████████████████████████████████████████████████████████████████████████████████████
