████████████████████████████████████████████████████████████████████████████████████████████████████████████████████████████████████████████████████████████████████████████████████████████████████████████████████████████████████████████████████████████████████████████████████████
████   ██        █      █ █      ██ █   ████ █  █ █    ███████   ██   █ ██    ███ █  █  █ ██ █ █     █        █       █ ███    ███ ██ ██  █   ███ █ ████ ██  █  ██  █  █   ███  █████ █████ █ ███ █  █  █ █ ██████    █ █    ██   █ █ █ █   █  █ █    █   ██ █  █ █ ██  █  █  █ █ █ ██ █
███████ █ ██  ███  █  █  █  █ █ █   █ █  ██      █  █  █  █ ███     ██ █   ██   █████ ██ █ █  ██ ██     █ █  ██ ██ ██████  █  █   █ ███ █  █ ███ █ ██  █   ██ █ ██████    █    █   █  ██ █ █ ██   █ ███  █   █ █ ██ █   █ █ █      █  █  ███     ███ █  ███  █ ██ █ █     █ █    █  ████
███ █  █   ██ █   █ ██ █ █ █ █    █   ██  ████  █ █ █ ██  █ █ ██  █   ██  █   ██  █  █  █ ██    █         █    ████ █   ██ █  █    ███   ██ █      █       █ █        ██ ██    █   █ ███ ██   █  ███  █ ██       █ █  ██████  █ ██ █ ██ █  ██ █ █      █    █████  █████████ █ ██  █  ██
██  ██ █ ██ █████  █   █  █   ██    █   █ █  █         █   █        █  █   █ █ █ ██      █        █ ██  ████    ██     █  ██ ██ ██ █████   █ █  █     █████ ██   ████      █ █    █  ██  ██  █ █ ███  █     █  █ █   █  █  █ █ █  █ █  █   █ ██  █ █         ██ █   █     ██   ████ ████
█ █ ███  ███   █ █ █           █ ██ ███    █   █ █ █ █  ██ █    █    ███ █  █████ █████   █ ██ ██  ██   █ ███ ██  █ █  █     ██   █   ██ ██ ██ █ ███  █ ███ █  ██ █   █   ██ ██     █  █████ █  █ █████ ██  █  ██  ██  █ ████ ███   █  █    █ ██  █  █   █ ██ █  █ █   █  █  █████ █  ██
█ ███     ███  ██ █████   ██ █  █ ███ █      ████  ██ █   █ ██  █ ███  █   █ ████ ██   █ █   █  █ █         ██  ███ ██ ███ ██   █ █ █ █  █   ██ █   ████ ██  █ ████  █   █     █ ███ ██  █  █  █   █ █  █ █  ███   ██ █    █  ███  ██   █  █████   ██  ██       █     █       █       ██
██  █     █    █ ███  █   █  ██  ██ █ █ █ █  █            ██   ██    █  ██   █      ███   █   ████  ███   █  █  ███  █ █  █    █  █ █ █   █    █  █  ██ ██ █       █ ████  █ ██  █████ █   ██    ██ █  █ █  ███ █ █    █  ████ ████  █ █    █  ███  ███ ██    █ ██ █    ██ ████  █   ███
██ █ ████     ████ █     █   ██  █ ██     █  █ █     █    █  █ ██ ██     █ █ █ █    ██    █ ███ ██ █       █ ███  █ ████ ██ █     ████ ███ ██       ████ ███ ██        █      █   █ █  █  █ █  █ ███ █ █   █████ ███  █   ██ ████  █  █  █  █   ██  ██ █   █ ██ ███ █ █   █  █ █      ██
███ ██ █  █  ████   █ █ █ █ ██  █  █ ███ ██ ██ ██ ██  ██ █████    █ ███ █ ████         █   ███   ████       ██ █  █████ ██ ███ █ █ ███ █  █ █   ███ ███    █ █        █ █   █   ██ █ █  █     █ ██ █ █    ███  ███   ██ ██ █  █████ █  █   ███ ██ █ █  █████    █  ██ █ █   █ █     █  █
███   ███ ██ ██  █ █ ██  █ █ ██ █ █ █ █  ██   ██   █  █ ███  █ █  ████ ███ ██ █ █ █ ██  ███ ████  ███   ████ ██ █    █  █ ██ ████   █  ████  █ █   █ █ ██      █  █ ██  ██ █   ████████    █  █████ █ ██ █ █  █████    █ █ █   █ █ █  ██      █  █ ██ ██    █       ██ ███ ███   █ █████
██ ██ █ █  █ █  █ ██   ███  ███       █  ███ █ ███   █   ██████         ██ █ █     ████   ██ ███   █    ██ ███  ███  ███ ██  ███  █   █ █    ██ █  ██ ██  █  █ ███   █   ██ █   █ █ █  █  █      █ ██  ████ ██  ███ ███    ███  ██   █ ███ █      ███  ███         █    █    █   ███   █
██ ██ ███ ██   █  ██  █        ██   ██  █   ███ █ ██  █ ███ █    █  █ ████    █ █       █ █ █     ██    █     █   █ █████    ██ ███████████████   █  █  ██ █ █    █ █   █   █    ██  █  █   ██ ███ █ █  █  █  ██ █ ██   ██████  █ ██████  █ ███   ████  █ █ █   █    █   ███ █    ██████
██████    ██         ███     █    ██ █ █  ██  ██  █    █    █ ██  ███ █      ██  █ ██ █ █  ██     █    █     ███   █      █████   ██ ████  █    █     ██   █  █ █ ██  ██ █   ███  ███  ██ █████     █  ████████  ██  █ ██ ██  █  █      █ ███ █ █ ██ █ █    █ █  █ █   ██    █  █     ██
█ █   ██  ███    ███ █  █  █ █ █    ███  █ █  █   ████ ██ █ █  █ █    ██   █    ██ ██ ██           ███ █    ██    ██  ███   ███     ██ ████ █ ████    ███        █ ██ ██  █ █  █  █ ███ █   █  ██ █  ██  ██    ████  █ █  █  █  ██ ██ ██  █ █    █        █ █  █   █  █ █      ███  █ ██
█ █ █ █ █    █ █  █ ██ █  █ █    █ █ ██ ██ █ ██  █ █      █       █████  █  ███ ███    ██   ██ ███  █ █ █ █  █  ██ █  ███    █   ██  ██  █   █ █ █  █ ██              █ █  █ █ █ █   ████   ██ █ █  ███  ███ ██  █ █ █      █ ██   █ █ █    █  █  ██   ███ ███    █      ███       █   █
██ █   █  █   ███  █   ██ █   █       ███  ███ ████████  █     ███ ████ ███      █     █ ██   ██    █ ███ █ ███ █    █ █  ████  █ ████ █ ██  ██ █  █ ███  ██   █  ██ █ ███ █████     █████ █ █    ██  ██      ██  ███ ███ █    █ █████  ██    ██ █ █ █  █ █       ███     █ ███ ████   █
█ ███ █  █     █   █ ███  ████  █ █████  █      ██ ████  ██    █  ██    █ █  █  ███ █     █  █  █  █  █  █ ██      █ ███  █ █ ██    ███   █ █     ██████   ██     █  █   ██  █ █ █ █ █ █ ███  ████ ███  █ ██ █   ████  ████  ██ ██  ██ █  ██   █ █ █ █  ██  █  █   █  ██ █  ██ ████    █
█ █  ███ █ ██ █    ███ █     ███  █ ██ ██  █ ██ █ ██ █      █ ████ █   █   █   ██       █ █   ██   █    █  █     ████   ███   █  █ ██ ██ █  ██  ██ █ ██ ███     █ ███  █ █    █ █ ████  █ ██      █   █ ██   █ █ █████      ███   ████  █ ███   ██ █   █      █  ███ ███  █  ███  █ ██ █
█ █  █   ███  █ █ ██ ██ █ █ █ █  ████  █ ██ ███ █    ██  ██        █  ██  ██ █    █ █   ██    █  ██ █ █ █    █    ███ █ █ █        ████ ███  █ ██  █  █   █  ██ ████ █ █ ███ █           ██████ ███ █ █ █  █    ██ ██     █ █  █ ██ █ █  █████     ██     █     █ █ ██ ███  █    █ ███ █
███  █ ████ █      ██  ███ █  █   █ ███ █ █    ██ █  ██          █ ███   █ ████ ██  █  █  ██  █       █      █  █ ██ █ █ █       █ █   █ █ ██ █   ██ ██     ██████   █████  ██ ██  ███ █   ██  █    █  █   █████   █   █   ██    █████     █  █ █     ████  █ █████ ███ █  ██ █ █    █ █
██    ███ ██ █  █   ██ █ █ ██   █ ████     █       ███   █ █████  ███   █ ███ ██   ██ ██ █ ██ █   ████ ████ ██████████ ███ █  █    ██  █    ██ ██  ████  █  █████ █ ███  ███  █ █ ████ █  █   █ ███ █    ██  ██   ███ ███   ███ ██ ██     ███ ██  █ ██   ██ █   █   █  █ ██       █ █  █
█████ ██ █  ███    ███ █ ████    █ █ █████  ████ ██ █ █  ██  ██     █   █     █ █ ████  █ █  ██ ██   ██ ███ █  █ █     █ ██    ██    █   ███ █  █ █  ██████ █   █    █  ██ ██  █ █ █  █    █  █ ██  █  ██      ██ ███  ██ ███ ██   █ █     █  █      █   ██  █  ██     █ ███ █   █   █ █
██   ██ ███   █    █    █  █ █  ███ █   ████   ██ ██      █ ██  ██ █ ██  ██  ██ █  ██  █ █  █ █ █    █ ███  ██   █ ██  █  █  ██ ██ █ █     ██ ██ ██ █  █ ██ █ █            █ █ ██ ███      ███  ██ ██   ██    ██  ██ █ ██████ █  █  ████ ██       ███ █  █ ████  ██████  █  █  █  ███  █
██████  █ ██    █ █ ███  █████ █ █   ██  ██ █ █    ██ █   █  █   ███      █    █ █ ████ ██ █  ██ █   ███ ████████ ████  ██  █ ██ ████ █  ███    ██████  ██  █████  ███ █████    ██ █ █      █ ██  ██   ███████████   █   █ █████   ██  ██████ ██████████  ███ █ █   █   ██   █  ██ █ █ █
█   ████ ██ ██ █ █████  ██    █ █   █  █  █ ██ ██  ███  █ █         █ ██  ████  ██ ██   ██ ██  ███  ███    █ ███ █   ███ ███  █ ██ █  ███ █   █ █ █  █ █ ██      █ ██ ██ █     █ ██  ███   ███ █ █           █ ██ █  ██ █ █ ███   ██    █ █   ██ ██       ██    █ ███     █ █      ██  █
█  █ █ ██ ██ ███████ █ █  ████ ██ ███ ██ █  ████ ███  █ ████████           ██       ██ ██ ██   █  █ ██   █       █ ███ ██████ █  ███ ███ ██ █  ████    ███ █    █ ███    █ █     █  ██         ███  █   ███   █ ██ █ █ █            ██ ███  █████  ████  █  █████  █     █ █ ███ █   ███
█    ███ █ ██ █      █ ██ ██ █ █   ███  █ █ ███ █  █  █ █ █  █ █ █   ██████   █ █████  ███  ████ █  ██████  ██ ██ ██   ██  █    ██ █ █ █ █ ██ █ █ ████  █   █     ███   ██      █    █ █ ███      █  ██     ██ ███ ██  ███ █  ███ █  ██    █ ████ ██ █        █  █      ███ ██ █ ██  ███
█   █ █ █  █   ██ █  █  █ █      █   █    █ █ █  ████   █ █ ██ █ █  █  ██  █  ██ ███  ████ █ █ ██ ███ ███   ██ █ ██ ██████  ███    █  ███   ██ ██████████     █ █ █ █  █ ██ █  █     █     █    ███    █    █   ███ █  █ ██ ██ █    █ ██  █  █     █   █ ██ ██    ██   █ ███  ███ █   ██
█ █ █ ███ ██     █       █████   █  █  █   ██   ███ █ █  █  ██    ████████  █   █ ██ ███  █ █   ██     █  █ ███ █     ███ █  █  ███  ██   █   █ █ ████ █ █ ██ █ █  ██ ████ █ █       █ █  ██████   █   ███ ███     █   ███ ██      █ ███     ███   █████ █ █ █      ███   █  █ █   █████
███  █    █  █ █    █  █          █    █████  ███  ███  █ █   ██   ██ █   ████    █  █   █  █ █ ████  █  ██  █   █████  █ ███  ████ ██  ███     █ █    █        ████ ████  █ ██  ████  ██ █  ██     ██   ██ █      █  █   █  ██       ██   ██ ██   █ █   █  █   █  ██████       █   ██ █
█████████   █ █   █   █   ██  ██ █  █            █   ██   ██  █   ██ █   █ █ ███ ████   ███ █    ██ ███  ███   █████   ██   ██ █ █████     ██  █  ██ █ █   █ ███     ██  █ ██  █ ███ █   █ ████       █ █  ██   █   █ █ █ █████ ███      ██ ██      ██      ██ ██ █   █████   █    █ █ █
██  █  ██  ███ █  ██ █   ██  █ ██  █  ██ ██ ███ █   █  █ █  █ ██ ███  █  █  █    █  ██   ██ ██ █ █  ██ █ █ █   ██    █   █         ██ ██      █ █ ███ █ ██  █  █ ███ █ ██  ██  ██ █  █ █  ██  ██ █  █  █  █     █ ██████ █       █ ██ ██  █████   ███  █████ █ ███    █ ██  ██      ████
█    █  █  ██    █ ███   █   ███ ████          ██ █  █  █   ██  █ ██ █ ████   █ ██ █      █ █ █ █  █ █  ██ ███ █       █  █ ███ █         █   █ █████     █████ █  ████ ██ ██  ███ █ █  ██ ██ ██    █       █   ███ █  █████ █████      █  █    █  █   █  █ █ ███  █      ██  █ ███  █ █
█  ███ █ █    ███ ██ ██████ █  █████ ██ ███ ██       ████ ██   █  █████  ████ █   █      █  ████ █ ██  ██ █  █ █ █        █ █ █    ██  █ █  ███ ██     █  ███ █   ██ █    █  █ █████       ███  █ ███  ██ ██ █ █    ██    ██      █ █ ██ █ ██ █  ██ █ ██  █ █ █ ███████ █  █   █  █    █
██ █ ██       █   ██  █ █      █    ██     █  ███████ █   ██      ███ ████ █ █ █  █ ██ █   ██ ██ ███  ███ █      ███     █     █       ██    ███ █         █ █ █    █ █   ██     ██  █  █   ███ █ ███  █ █ █  █  ██ █ █ █  ██  █ █  ████ █  ██████  ███ ███ █  ██    ██   ██ █ █   ██  █
██    █ █ █ █ ██ █ █ ███      ██    █   ███ ██ █ █    █ █      ██ █   █   █   █   █      ██  █ █  ██  █  ██ █  ████     █ ██ ████         █     ████ █  █████████  █  █  █ █████     ████████ ███ █   █ ███       ██    █ █ ██      █     ██ █    █ ██ ███   ██    ██ ███ █ █ █ ██    ██
█   █ █ █   █    ██ █ █ ██  ██████  █  █    █ █   ██     █ █  ██    ███ █    ██     █  █     ███ ██████ ██   █ █ ██  █ █  ██ █ ██ █   ██ █      █    █ █ █   ██ █   █   ██     ███████  █   █ ██ █    ███    █ █ █ ██ █   ██   █  ██      █     █ ██  ███ █ ██ █   ████     ██  ██ ██ ██
██   █  █ ██  █  █ █  █ ████ █ █ ██ █  █ ██ ████  ███ █  █ ██ █ ████ █████      █ █ ███████  ██ ██   ██  █   ██  █ █    █  █    █ ██ ███    ██  █ █  █  █ █    █████ ██   █  ██       █ █  █    █ █   █  █ ██ ██   █ █ ██  ███ █ ██ ██           █████         ███ ██  █████ ██ █   ████
█ ██ █  █ ███ █  █  █   █   ██████    █  ██ █   ██  ██ █ █  █     ███   █████████ █  ███      █    █  ██ ███     ███  █ █ ███  █ ███ █████ █   █ █ █  █ █  █ ██  ███       █ █ █ ███     ██ ██       ██ ██    █ ██  █ █  ██ ██    ███   █    █ █ █   █ █   █ ███  █   ██ █ ██ █  ██ █  █
██ ██ █  ██  █    █ █ ██   ██    █  ███  █  ███     ███ █     ███████████  ██      █   █ █ █  █   █   ██   █ █  █ █ ██ ███ █ ██   ██  █  █ █   █ █  █    ██     ██   █   ███   ███  █ ███  █    ██ █   ██ █   ██ ███ ██ █ █   █  ███ ███    ████   █  ██ █    █ █   ██   █████    █    █
██  ██  ███  █       █ ██  ██ █  █  █           ██ █ █   █     ██  █  █    ██    █ █   ██████ █ █ █ ███    █ █  █    █ ██ █  █████ █   ██ █    ██████ █ ███     ████ █  █   █ █  ██  █   █ ██ ██ █ █ ███████ ██   █ ██    ████   █ █  ███   ████  █ ████ █ ███ ██  █  ████████     █  ██
██   █   █  █  ██ █     █     ██ █ █  █  █ █████ ███  █     ████  ███ █  ███  █ █    ██      ██  █  █    █   █ █   █  █   █  █      █  █████ █ █ ███  ████   ██████   █████    █ █           █ █  █████ █ ███  █ █ █ ███ █ █ ██        █   ██ █   ███     █  ████   ██ █  █ ██ ████ ██ █
█████  ████  █ ████ █  ██ █  █  █ █  ██  ██ ████      ██ ██ █     ███ ██████ ██ █   ██ █ █ █  █ ██ █ ██████ ██      █ █ ████ █ █ █ █  █  █  ████  ██  █ ███  █   ██   ██ █  ███ █     █     ███ █    ███    █    █ █  █ ███ █   █ █  █   ██ ███   █  ██  █ █ ██ █   ██ █    █████ █ ██ █
█     █ █████ ██  █ ████   ██ ██ █   ██ █ █ █ ███  █  ██  █ █ ██ █    █  █   ██  █   █  ██  █    █    █ ████████ ██ ███ █     █  █  █ █ █ ██ █  █     █   ███   █ █  ██   ██ ██ ██ ███   █  █    █ █   █   ██ ██ ██   █ █ █  █ ██ █   ██  █ ████ █ ██       ███ █     ███    ██ ██ ███ █
████       ██  ██ ██         █ ███ █   ██     ███ █ █ ███ ██  ██     ███  █ █ █ ███ ██ █ █   ██ █ █ ██        █ █ █   █  █ ██     █   ██████████ ███ █   █     █   ██     ████  ██   █  ████     ██ ██   ██ █  █ █  ██ ██  █ █ █ █ █  ██ ██  █████ ████    █ █      █ █        ██  █ █ █
█    ███ ████ ███ █  █ █ ███████ █ █      █ █ █   ███ ███     █  █     █ █  █      █        █ █████       █ ██  ███████ █  ██ ██ █ █ █ █  ██ █     █ ███ ██   ██  █  █ █ █  ██  █ ████  ██ ██ ███ ███  █ █   ██  █       █████ █ ████ ██    ██████  ██   █  ██  █ ███ █ ██  █ █   █    █
██████ ███ █ ████ █  ███   ██ ██  █ ████  █     ██ █  ██  █ █  █     ██  █ █ █ ██ █  ██ ██  ██ █  █ █  █   █  █ █     █  ██ █  █ ██ █   ██████████   █  ██  █ █ █ ████████  █ ██ ██ █  █ █ █     ███ █ █  ███   ██ █    █   █  ██ █  █      ████ ███      ███    █  ██ █ █    █ ██ █ ███
████  █ █ ███      █  ██     █ █  █ █ █    █ ██     █ █ █ ██████       █  ██ ██ █ █   ███ ██ ██ █    █ ██  ███ █  ████ ██  █ █ █ █  █ █  ██ █ █   █ ████   █  █ █ █ ███      █ ██  █ ███ ███████   █ ████   █  █   █  █   █ █   ██ █  ███████   █ █ ████    █   █   █     █   █ ████   █
█  ██     █ ██  ██      █     █   ████  █  █ ██  █ █ █      █    █  ██  █      ████   █ █  █     █ ██    █    ██     ███ ██     █  ██  █  ████ █    █  ██ █    █ ████   █  ████  █         █  █ ████ █     ██ █ █ ██  ███  ██   █  ███        ██████ ██   ██    ████  █        █  █ █  █
█   ██     █       ████  ████ ████ █      ██ █████    ██ ██████  ██ ██ █   █ ███ █   █ ██   █   ███ █ █  ███   █ ██   ████   █    █ ██   █  ██    █  ██ █   ███  █ █ █ █   █          ██ ███ █ ██  █   ██████   █   █    █       █ ███ █  ██ ███      █   ██ ██ ██   █████    █ ████ █ █
█ ████ ██ █    ███  █   █    █ ███  █  █ █    █ █    █ ███  █ █   █  █  █  ███  ███  █ █ ███  █ █ ██ █    ███   ███ █ █ █   ██ █ ██ █  █   █  █ ███████ ████  ██ █      ██  ███ ██  █ █ ██████    █ ██ █ ██ █      ██  █ ███ █    █  ██ █   ██ █  ██ ██ █████████      ██ █   ███ █ ████
██  █   █  █       █ █ █ █ █ █ █ ██  █  ██  █   ████  ██ ██  ██  ███ ███  ███ ██   █    ███  ██ ██ █   █   █████ ██       ████    ██  ███  █ ██     █ █       ███  █ █ █ █ █   █  ███     █ ████    ██ ███    █ ███  ██ ████ █ █ █████     ██ ███ █   █ █  █   ██ █ ██ ███    █ █   ██ █
█ ██    █████     ██  ██    █   ███  ███         █    █      ██   █████ █ ██  █ █ ██   ██   ███ █  ███████ █ █     █     ████ ████ █  █    █ █   ███    ███ ████  █     ████ █ █ █  ██  █  ██      █ ██  ██   █ ██ ██      █  ███ █ ████            █  ██ █ ██  ██ ██  ██ ██       █████
███ █  ███ ██ █ ███  █ █   █  █  ███  ██  █ █    █    █ ██    ███     █ ██ ██      ██████  ████ █   █ █ █   █  █ █ ██   █████   █  █ █ █  █    █ ██ █   █  █     ██  █ █ █ █         █    ███ █████  █            █  █ ██     ██  █    ████  ██  █  █   █   ███ █  █    ███    █ ████  █
█ █ █ █  ██████    █ █ ██ ████  █    ██   █ ██ ██   █    █ █ ████ ██ █ █      ██ ███ ██  ██ ██ █ █    █ █  ████ ███ ██    █ █████ ██  █ █   ██   ███  █ █  ███ █    ███      █ ██ █ ███  █  █  ███  █  █  ██ ██   █     █ ██    █ █ ██████  █  █ ██  ██ ██ █ █ █ ██  █ █   █   █████   █
██ ██   █    ███ ███        ██    ███  █ ████    ██   █████ █ █     █    █ ██   █ █ █  ██  ██    ███ ██  █ ███ █ █  ████  █ █  █  ████  ██ ██ █    ██  █ ████  ████████ █  ██ ████ █ ████ ██  █  █   ███ █ █ █████ █  █    ██   ███ █  ███ █ █  ██████ ███ █    ███      ██ █ █ █ █  ███
█ █ ██         █    ██  ██   ██   █ █ ███ █ █ ██         ██   ██ █ █  ██ ██  █    ██    ████ ██ █ ██ █    ██  ██  █ █ █  █  █      █   ██          ███  █ ███  █ █  ██ ████ ██    █  ██ ██ ████ ███  ███ █ █ ██████ ███████ ███   █    ██       █ █   █ █ █  █     █   ██   ███  ████  █
█ █ █  █  █ █  █  ██ ███  █ ██ █  ██  █  █ █  ██     █  █  ██ █ ██ ██████  █       █ █ █  ███ █    █ ██████ ███ █ █ ███ ██    █ █ ██    ██ █ ███     ██   █  ██ █ █   █ █ █  █  █  █  ██ █         █   █ █ ███     ██      █ █  ██ ██ ██ ██  ██ █  █   █ █      █  █   █        ███    █
█   █  █    █ █ █ █   ██ ██   █████ █    █  ██  █  ████  █ █  █████   ██ █  ██ █ ██ ██ ██  █  ██ ███ ███ █ █ █   ████    █ ███  ██ █   ██  ███ █ █ ███    █ ████████        ██   █  █  █   ██ ██ █  ███ ██ █ █  █      █       ███ ████  █  █ █ █ █  █  ███ ██ █  █████  █ █ █ █ █ █  ██
█  ███  ██ █   ██      ██ ████    ██  █  █     ██   █ ████ █    ███ █████████  ██   ██  ██ █ █ ███ █  ████  █    █  ████ ██ █   ██ █  █ ████ ██████ █  ██     █   █ █ █    ██  █ ██   ███  ██ ██ ███     █   ██  ██       █   ██  ██   ██ █ █ ██ ███ █  ██ ██   █  ██ ██   █ █   █ █ ███
██ ██   ████ █ █    ██ █  █  █   ██   █ █ █  █ █ █  ███   █  ██ ██      ███ █       █ ████   █   █  ██ █   ██  █ █    █ █  █ █  █ █ █ █   ██   █  █ ████ █ █  █  ██ █   █  █  █ ██   █    ███ ██████ █    █   █  █  █ ████ ███ ███   ██ █ █    █ █ █  ██ ███ ████   █ ██ █  ███      █ █
█ ██    ███ ████  █ ██ █ ██ ███  ████ ██       ██     █ █ ██    ████   █       ███ ██  █ █  ███    ██ ██  █   ██  █████ ██ ██    █ █ █ █ █  █ ██ ██  █ ██  █      ██ ███ ████ █ █   █   ██     █ █████  ██   █   █ █████ █ █      █████  █ ████   █ ██ █ █ █       ███    █ █   ██     █
█ ██   ████   ███ ██   ██        █   ███ █  █ █  █ █ ██ █ ██████ █    ███ █ ██     ██     ████  █    █ ███ ██ █   ██  ██  ██ ██   ██  ██ █  █ █  █ ███ ███ █ ██   ██ ██████     ██  █ ██   █ ██   █ █   █   ██     █ ██████ █  █   ██ █  ████  ███      ██   ██     ██   ████    ███ ███
█   █  ██  ██  ██ █ ███ ████   █  ████  ████ ████ ██    ██ ██   █  ██   ███████         █ ██  █ ██ █ ██     ███ █          ████ █ █  ██  █ █  █ █ █   ██  █ █ █   █ ███ █  ██ ██ █    █ ██  █ █  ██  █    ██  █ ██  █   █  █ ██   ███ █           ██    █   █ ██ ███        ██ █   ██  █
█      █  █   █ █   ███  ██ █ ██  ███ █     ██  █ █     █ █ ██ ██  ███ █████  █ ██  █  █ █ ███ █  █ ██ ██  █  ██ ██████ ██ ██ ███   █ █      ██  ███  █ █    █ ██ █ █ ██  █ ███ ███  █   █  █  █ ██ █ █ ███ ██  █ ██  █ ██        █   █        ███ █ █   ████ █   █ █   █  █   █     █ █
█  ███ █  ████         █       █  █  █ █      █ █   █  ███    ██████ █     █       ██  █ ██    █ ██████ ██ █ █   █ █ ██ █       ██  █   █  ██   ████ █  ██  ███  ██   █  █ █████     █   █ ██████    █████ ██  █   █ ██   █ ██ █████ ██ █ █ ████ █ ██ ██  █  █ ████  ██  █ █  █  ███ ███
████████████████████████████████████████████████████████████████████████████████████████████████████████████████████████████████████████████████████████████████████████████████████████████████████████████████████████████████████████████████████████████████████████████████████████
