████████████████████████████████████████████████████████████████████████████████████████████████████████████████████████████████████████████████████████████████████████████████████████████████████████████████████████████████████████████████████████████████████████████████████████
█████████████████████████████     ████████████████████████████████   █████████  ██████████  ████████████████████████   ███    █████████████████████████  █████████████████████████████████████  ██████████████████  ████████████████████████████████████████████████      ███████   ████
██████████████      ████████        █████████  ███████████████████    ████       ████           ███████████████████            ███   ██  ███████ █████     ███████████   ███████    █████████      █████  ███████     ██████████  ████████████   █████████                 █████     ███
█████████████        ███████        ██████      ███   ████████████     ██                       ████████  █████████                       █████   ███       ██████       ██████      ████████       ███    ██████      █████       ██████████     ███████                 ██████      ██
█████  ██             ███████      ██████       ██    ████    ████                              ████████     ███████                      █████              ████        █████       ███████         █      ██████     █████       ██████████     ███  █               █████████      ██
████                   ██████      █████       ███    ███      ████                            █████████      ███████                      █████             ████        █████      ███████                  █████     █████        ████████      ██                  █████████       ██
███                                           ████    ███       ███                           █████████        ██████                      ██████           ████         ██████    ███████                    ███      █████         ███████                          ████████        ██
██          ██                                ████   █████      ███                         ███████            █████                       ███████    ███  █████     █    ██████   ██████                             ██████         ██████                           ███████         ██
██          ███                               █████  ██████     ███        █               ███████              ███    ██                 █████████  ██████████     ███    █████    █████                             █████           ████                      ██     ███           ███
██          ██         ████                  ███████  ██████              ███              ██████                     ████               █████████████████████      ███     ████      ██                              ████                             ███     ████                  ███
██                 █████████      █         ████████   █████               ███              ████                     █████               ██████████████████                 ███                                        ██                              █████   ████                  ███
█                 ███████████    ███       ██████████   ████                ███             ████               █     █████                █████████████████                  ██                                                                        ██████   ███                  ███
█                 ███████████    ███    ████████  ███    ███                █████          █████              ███    ████                  ████████████████                  ███                                                                        ██████   █        ████       ███
█                  ██████████    ███   ████████    ██    ████               █████     █████████                █     ███         █          █████████ ███████                ████             ███                                                        █████         █████████      ██
█                    ████████   ███   ████████           █████             ██████    ████████                        ███        ███         ████████    ██████              █████    ██    ████████               ██                        ██           █████         ██████████      █
█         █             ██████████    ████████           ███████          ███        ███████                        ███     █          ██   ███████         ███████         ████    ████  ██████████             ████   ███                ████          ██████         ███   ████     █
██       ███             █████████    █████████         ███████████      ███         ███████              ███      ████    ███        ██     █████           ██████         ████    ████████████████             ████   ███               █████           █████                ███    ██
██       █████  ████     ████████     █████████         ███ ████████     ███          █████              █████     ███              ████                     ██████         ████     ███████████  ██             ████                    █████             ███                  ███  ███
███       ███████████    █████        ██████████             ███████                   ███               ██████    ███             █████                     ██████         █████     ██   ████                                          ███                                    ████████
███        █████████████ ████         ████  ████            ████████                                     ██████    ███             █████                 ███████████        █████           ███                                           █                                     ████████
███             ████████   ██         ████   ██            █████████           ████                       ████     ███              ███               ███████████████       ████            ███                                                         ██                     █████████
██               ██████     ██        ████       ███     ████████████         ██████                               ███                       ████████████████████████        ██    ███      ████             ████                                      ████                   █████   ██
█    █          █████       ██       ████        ███    █████████████         ██████                                █                       █████████████████████████              ████      ███████        ██████                                     ████         ██       ██████    █
█   ███         ████        ███     ████         ███   ███████████████       ██████                          ██                  ██         ████████████  █████                    ███        ███████       ██████                  ███                ███         ████      ███████   █
██  ████        ███          ███    ████          ██   ████████████████       ███                           ███                 ████        █████   ███    ███                                 ██████        ████                  █████     ██         ██         ████          ████ ██
██   ███                     ███    ████               ████████████████                                     ███                 ████       █████           ███          ██                      █████                             ██████    ████          ████      ██            ██████
███   ██                             ███               ████████ ███████                                ██                       ████      █████            ████        ███        ██            █████                  ██        ██████     █████         █████                    █████
█████                                ████               ███      █████                                 ██                 ██   ████       █████            ████       ███        ████           █████    ██           ██████    ██████      ██████         █████         ██         ████
██████                                █████                      █████                                ████                ██   ████       ██████            ███        █         █████         █████    ████          ██████████████         █████          ████        ████        ████
███████                                █████                      ████                           █████████                      ██        ████████                               █████        ██████    ████          █████████████           ███     ██      █        ██████        ███
████████                               █████                       ████         ██              ██████████                                 ████████                              █████       ██████     ████          █████████████                  ████             ████████        ██
████████                               ████        █          ██    ████        ████            ██████████                                 ████████                      ██     ██████      ██████     ██████          ██  █████████      ████       █████      ██  █████████         ██
███████                          █    ████        ██    ██   ████    ████        ████            ██████████                                ████████               ███   ████   ████████     ██████     ████████              ███████     ██████      █████     ████████               ██
███████                         ███   ███         ██   ████  ████     ███        ████    ████    █████████████                             ███████               ██████████   █████████      █████     █████████              ██████    ███████     █████   ██████████                ██
███████                         █████████     ███      █████  ██       █    ██    ████████████   ██████████████                           ███████                █████████   █████████        ████          █████             █████     ██████     █████   ████████                  ███
████████                        █████████    ████     ███████          ██  ████   ████████████   ██████████████          ██              ███████                  ████████   ███████           ██             ████             ██      █████       █████   ████                      ███
█████████                █      ██████████   █████    ███████         ██████████   ███████████    ██████████████        ████            ███████                    ██████    ██████                            ██████     ███         █████         ███     ██                    █ ████
█████████                        █████████████████     █████         ███████████   ███████████         ██████████       █████           █████      ███              ████     █████                              ██████   ████        ██████                                      ███████
████████                            ███████████████     ███         ███████████     ███████████        ██████████      ██████            ███      ████████          ████     ████                                █████   ████       ███████                                      ███████
███████                                  ███████████                ██████              ████████       ██████████      ██████            ███     ██████████          ██      █████ ███                            ███    ███        ██████                     ██                ███████
██████                                    ██████████                 ███                     ████     █████████        ██████            ███    ████████████   ██            ██████████                                   ██        █████                     ███           ██  ████████
█████                                     ██████████                       ██                 ███     ████████         ██████            ████  ████     ██████████            █████████                                    ██                                 ████          ████████████
█████                      ███        ██ ██████████                        ████               ███      ███████         ██████             ███████         ████████             ████████                        ██          ███                                ████          ████████ ███
████                      █████       ██████████               █           █████             ████        █████        ███████              █████           ███████      ███    ████████                       ████         ████                               ████           ██████   ██
████                      ██████        ███████               ███           ████              ██         █████       ████████              ████             ██████     █████   ███████                        ████        █████                               █████     ███    ████   ██
███         █            ███████         ██████                              ██                       ████████    ██████████               ████             ██████     ██████████████                          ██      ███████                                █████    ████     ██    ██
██         ███           ██████           ██████         ███       ██                                ████████    ███████                ██████             ██████   █   █████████████                                 ███████                             █   █████   █████           ██
██        ████           █████             ██████       █████     ███                               █████████   ███████                ██████              █████   ███   █████████████                                ███████          █████                   ███   █████            ██
██        ███            ████               ██████      █████████████                               █████████   ██████                ██████              ██████   ████   ███████████████                              ██████         ████████                      █████             ██
██         █            █████                ██████     ███  ████████                               █████████   ████                  █████               ██████    ███   █████   ████████           ████               ██████       ██████████                    ██████             ██
██                  █████████         ██       ████     ██    ████████         ███                 █████  ████   ██                    ███                 █████           ███     ████████     ███ ██████       █       ██████      ███████████                  ████████            ██
██                 ██████████     ███████       ██      ██    █████████       ████                 ████    ███             █                                ████                   █████████████████ ████████   ███        █████    ████████████          █████  ███ ██████           ██
███                ██████████    ████████              ███     ██████████████████                  ████    ███                                               ██                    ██   ███████████   ███████    ███        █████████████████  █         ██████████   ██████          ██
████                █████████    ███████              ███        ███████████████           ██       ███     █         █                                                           ██     ██████           ███     ███        ██████████████              ████████     ██████          ██
████                ████████    ███████              ███                                  ████               █       ███        ██                                             █████      ████      ██     ██      ███        ████████████               ████         █████           ██
████                ████        ████                 ██                             ██     █████            ███      ███       ████                                           █████                ████    ██       █          ███████████               ███          ████            ██
████                ███          ██                 ███                            ████       ███          ██████     █       ██████              ██                         █████                █████    ███                  █████████                              ███           ███
███            ███ ████                             ███                       ██  █████        ██       ██████████           ███████             ████              ██        ████                 ████      █████                           █                   ██     ████          ███
███   ██       ███████                                                       ██████████         █       ███████████          ██████       ███    █████  ███       ████       ████                 ████       ████                          ███                 ███     █████████    ████
████████        █████                           ██                           ██████████                   █████████          ██████    ██████    ███████████      ████        ██                   ██                                       █                  ███    ██████████    ████
████████         ████                                        █               ██████████     ██             █████████        ████████  ███████    █████████████    ████                 █                                    █     █                             █     ██████████     ███
███████          ████                                       ███               ███  ███     ████            ██████████      ███████████████████    █████████████    ███                                                     ███   ███                                  ██████████      ██
██████           ████                                        █                      ██    ████            ███████████    ██████████  ██████████    ████████████     ███                                                    ████████                                   ██████████      ██
██████          ████       ██      ████     ███                 ████                ██   ████         ██████████████    ███████████      ██████     ████████████     ███                               ██                   ██████              █████                 ███████████     ██
███████       █████       ████    █████    ████████       ███  ██████               █████████      █████████████████    ███████████      ███████     ███████████     ████                             ███████               █████        ███   ███████  ██      ███  █████████████    ██
█████████   ███████      ██████  ██████    █████████     █████████████             ██████████     ███████████████████  ███████████████  ███████████ ████████████     ████                            █████████             ██████       ███████████████████    ████████████████████  ███
████████████████████  ██████████████████  █████████████████████████████████████   █████████████  ████████████████████████████████████████████████████████████████   ██████    ██████████████████████████████████████     █████████    ██████████████████████████████████████████████████
████████████████████████████████████████████████████████████████████████████████████████████████████████████████████████████████████████████████████████████████████████████████████████████████████████████████████████████████████████████████████████████████████████████████████████
