████████████████████████████████████████████████████████████████████████████████████████████████████████████████████████████████████████████████████████████████████████████████████████████████████████████████████████████████████████████████████████████████████████████████████████
█████ ██ █    █ ███  ███    █    ██ █   ██  █       █    ████    ██  ████  ████  █   ██  ██        ██ ███    ██   █████  █   █   █   ███   █   █ █ █ █  █  ██ █ █  ██ ██ ███   █  ██   █    █ █  ██ ████ ██ █ ███ █ ████    ██     █   █  █   █ █   ███    █ █ ██ █    █ █ █  █  █  ████
█  ███     █    ██ █   █ █ █  █ ███   ███  ██   █ ████   ██ █ █ ██ ███ ████     ██   █   ██ █   ████ █ █  ██████  █  ███ ██ █    █    ██       ██ ████  █   █       ███   ███           ███ █    ██ █           █    █     █ █  █    █   █  █ █  ██    █████  █  ██ ██ ██ ██   ███  █  █
██  ██ ██   █   █ ██ █  █  █ █   ████ ██   ██  █   █  ███ ███ ██ █     █     ████ █   ███ █ ████ ███  ██ █ ██ █ ███     █    ████     █  █ ████      █ ██████  █████ █ █ █ █    ██    █ █   █  ██ █  ██  █  █  █ █    █      ███      ██████ █ █ █  ███     ██   █ ███ █ █    ███    █ █
███ █  ███ ██       ██ ██ █ █    █   █ █  █      ██ █  ██████████ ██  █  █ █    ███ ███ █  █    █ █ █  █    █    ███ ██ █ █        ██ █  █ █ █████ ██ ██  ████ ██   █  ███████ █  █    █         █  █ █  █ █ █ █ █ ███    █ █ █    █  ████      ███  █    ██ █  █   ███ ██  ██ ██ █ █ ██
████   ██ ████   ████ █ █ ██ ███   ██  ███ ██ ████   █ ██  █   █████ ██  █  ██  ██  ██████ █   █      ██   ███ ███   █   █ █    ██ █ ██  █  █ █ █       █ ██ ██ ███ ██   █ █          ██ █        █   █ ██ ██ ██     █  █ █ █  █  ███ ████ █  ██ ██ █    █████ ███   ███  █  █  █ ██   █
█  █ █████ ██  ██ ██████             ████ █  █  █    ██ ███ █ ███  ██ ███ █   █ ██   █ █ ███       ██████     ██ █     ██ ████ ██ ██  █  █ ██  ███  █ █ █  ██    █ █  ██ ██  █ █  ██ █  ██ ████ █ █ ██ █  ██ █   █   ██   ████ █     █  █  █ █     ███ ██   █  ████  ██  █   █ ████ █ ██
█  ████   █ ███   ██ █     █   █ █    █      ██ ███  █  █ █    █████   █    █   █  ███    ██    █ █   █  █ ███   █ ██   ██     ██     █  ████ ███ ██       █ █  ██ █ ██ ██ ██  █   █ █   █ ██  ██ ██ █  █  █ █ █     █ █    ██ ███  ██  █   █      ███  ██      █  ███   █  █  █ █ ███ █
█  ██  █  ████ █  ██  █           ███   █ ███  █     █  ██████   █   █     █     ███  ███ █ ██     █   █ ██  ████ ██ ██      █ █      █  █  ███████     █ ██ █  █ ██ █ ██  ████    █ ███ ██   █ █ █ █ ██   █ ███   ██ █   ██  █ █     █ █ ███ ██   █    ██   █ █ █       ███   █    ████
████ ███ █   ███  ███ █ ██ ████████ █ █   █████ ██ ███    ████ ██        █ █  █    ███  █    █ ███ █ █   ██ █  ███ █ ████ ██ ██  █   █  █    ███ █ ██   ████  ███████ ███    █  ██ ██ ████ ███ █ █    ███  █  ████    ████  █ █  ██     ███ ██  ████  █         █ █ █  ███   ██   █  █ █
█ ██   █ ██ ██ █ █    █  ██ █   ███ █ █  ██  ████████ ██   ██  ███ █ ██       ███ █ █  ███   █  ███ ██    ███ ██  █ ██  █  █  ███ █   ███  ██  █ █  ██   █    █  █           █    █ ███  ██ █    █ █████   ████ ███ █ █████ █    ██ █   ███  █ ████ █  █ █ █ ██  █ █      ███  █████ █ █
█ █ █ █   █  █ ███ █  █ █ ███  █ █ █   ███  ██ ████ ███   ██████   ██   █   ██   ███       █    ███  █ ██  ██ █      ███ █   █   █ █ █ █ ██████   █      █  ██   ████ █ ██   ██ █    █ █ ██ ██ █ ██    ██ ██ █ ██ █   ████    ██ █  █   █ ██   ██   ██  ██ ██  █ █  █ ███  █ █  ██ █   █
███ ██   ████  ████████   ██      ███   █   ████  ██ █  █ █  ██ ██  █ ██ █ ███ █ ████         ████ ██  ██  ██  █   ███ █  ██ ██ █ █   █      █ █ █ █  █ █   █   ██    ██ ███  ███  █   █  █    █   █ ██    █ ███   ██ █ ██  ████  █ █  █ ████████  █    █ █████     █  ███  ██     █   █
███ █ ███   █   ██     █   █ █   █ █ ████    ██  █ ████  ████ ██  █  ██  █    █ █ ██  ████ ███  ██ ███  ██ █      █  ██   ███     █       █  █ ██ ██   █ ██   ██       ███   █  ██  █   █ ███  █    █   ██ ██     ██  ████   ████  ███  █ █ █  █ ███  █  █ ██ █   █  █  █   █  █ █     █
██ █   █ ██    ██     █ █   █     █   ██  █████  ██   █  ██████    ███  ██ ██    █████  █   ██  ██ █ ███     █     ██ █  █ █   █ █  █   █ █ █ █ █ █    █      █  ███   ███ █ █     █ ████  ██ █ ██ ███  █ █████ ██ ████ █  ██ ██    ████ █ ██    ██     ███  █     █████   █ █    █ █ ██
█ █     ███████ ███   ██   █  █     ████       █ ███    ██ ███   ██ ████  ██   ██  █    ███ █ ███  █    █ ████  ██ █  ██  █ █   █ █ ██   █    █████ █ ██  █   ██ ████ █    █       ███   ██ ██  █    ███  ██  ██  ████   █       ██████ ██   █  █  █  █     ██   █ ████  ██  ████████  █
██  ██  ██ █ ██  █ █ █ ██ ██ ███  █████ █ █  █████   █   █ █ ██   ████      █   ███  █  █ █ ██  ███      ██ ██     ███  ███ █  █  █  ██ ██ █   █ █  █ ██      ██ █████   █  █  █ █ █  █  ██   █  █    █ ██  ███  ██ ██  █     █ █ █   ██ █ █ █ ████   ███   ██   █ █    █ ██  ██ █████ █
███ ██ ██  █ █    ████ █ ████      █  ████    █     █ ██████     █████  ██ █████ █████ ███ ████   ██ █   ██  ████ ██    ███  █ █  █ ██████ █   █  █   █ █ ███  █    █  ██ █  ████ ██     █  █  ██ █  █  █     ███████   ██   ██ █ █ ██ █  █  ██  ████  █ █ █     █  ██  █ █ ██    █    █
██ ██ ██  ███ █ ██   █      █     ██  ████████ █  █  █   █████     █ █   █ ██    ██ ██  █ █                 ████      █  █ █ █     █  █  ██ ███ █ █ █ █  █   █    █   █████ █      ██  ██  ████ █   █ ██     ███  █ ██ █  █ █  █   █  █████ ███  █████    █  ███  ███   █  █  ████   ███
█ █      █        ███████ █  █       █  ██   ███      ██   █      ██ █      ███  █   ██ █ █████  █ ████   █  ██ █ █  █     ██  ███ █     ██ █ █    █    ██    ███  █  █  ██  ██ ███ █ █   ██ █ ██ ██  ████   █     ███ ██ █    █ █ ██ █ █    ██ █    ███ █ ███ ██  █ █ ███ ██ ███ █ ██ █
█   ██  ███  ██   █  ██ ██ █ ███   ███ ██   ██ █ ████ █ ██  █   █    █    ███   ██      █  ███  ███  █ ███    █  █    █  ██████ █ █ █  █ ████ ██  ████     █ █    ██ ███ █  █ █ ███ ███   ███       █ █ ██ █ █  ███   █ ███ ███ ██ █ ██  ██         ███   ██ █   █      █ ██ █  █ █ █ ██
██ ██ █   █  ██  █ █  █ █   █  █ █ █    █   █    ██   █  █  ██ █ ███  ████ █    ███     █   █    █   ██   ██  ███  █  █  █  ██ █  ███  ██  █ ██  ███ █  █    ██ █ █ ████ █ ███   █ █ ██ █  ███  ██ █ █ ██ █ ███ █  ██████ ██   █  ██ ██ ███   █ ██   █ ██ █ █     █   █ ███  █ ██ █ ████
██  ██ █ █   ██     ██  ██   █     ██     ██  █  ██ █  █████ █  ███     █  ███ █  █   █   ██  █  ██  ████     ██ █  █   █ █    █ ████ █  █   ████ ██ █   █ █ █  ██ █   █   █  ██        ██   █ ██   █  ██ ██   █     ███   ███      ███ █ █ ██  ████   █ ██   ██ ██  ██   ██ ██  ██ ████
█████ █  ██  ███     ██ ████ ████ ██   █████   █  █    █     █ █████   █ ███    ██   █ █      ███ ███   █      █    █████ █   ██ █   █  ██████  █  █   █ ███   █ █ █    ██████    █ █  █ ███ █    ███ █  █ ██  █  ██ █ ██ █ █ █ █ █   █     ██     █     ██ ██ ██         ██ █ ██ █  █ █
█ █ █      ██ █   ██ ██ █   ███ ██   █ ██  █ ██ ██ █  █ ██  ███     █ █ ██   █ █ ████ █ █ █  █ █ █  ██ █ █  █   ███    ██ █  █ █       █  ██  ███ ██ ██  ██  █  ████████████ █████ ████  ██           █   ███    █   █ █ █     █   ██     █ ███ █ █   █    █ ████ ███ ████ █     ██ ████
█  ██  █   █  ██    █   ██ █     ██    ███ █ █ █ ██    ████   █  █ ██   ██████ █ ██  █  █ █  █  ███ █     █  ██  ██  ███   ██ █ █  █   ██ ██  ██ ██ ███ █ █  ██    █ █   ██  █  █  █  █ █ █  █ █     ██ ██ █████        █     ██    ██   █ █ █ █████ ██   █ █ ███  █ █ ██  ██████  ██ ██
██████ █ ██  ███ ██ ████ ██   ██ █  █ █ █ █  █ █ ██    ██████ ███  █    █  █ ██ █     ██ █████      █ ████ █ ██ █     ██  █ █       █ ██████   █   █ ██  █  █ ██  ██    ██ █ ████    ██ █     ███    ███     ███       █   ████     █   ██  █  █ █ █ ██████     ██   █ █ █   █ █ █ █   █
█████████  █ ███     █ █  ███      █ ████    █████ █  █████    ██   █ ██  ██  █   █ ███   ████ ██  ██   █   ███      █ █████   █ █       ██ █████       ███     ███ ████    █ █ █  █ ██  ██   █ █   █ ██    ██       █ ███  ██ ███ █  █ █ █  ██████ ███   ██ ██ ██ ██        ███   ██  █
██ ██ ███ ██  █         ██   ██ ██    ██ █    █ ████  █  ███ █ ██   ██ █ █   █ █ █ █ ████ █ ██ █  █  ███    ████  █       ██████  █ ██ ████ █  ██ █ █     █  █ █ █    █ █  ███ ██    █   █ ██████  █   █████ █ █ █  ██  █  █  ███      █  █ █  ███ ██  █ █  █  █   █ █ ███ ██ █       ██
█ █   █   ██  █ █    █  █ █ ██     █  ████     █  █    ███ █      █ █    █  █  ██     ██  █ █       █   █ █ ███ █  ███      ████  ██    ██  █████  █     █ █ █████ █ █ █    █ █ █  █ ██   █ █  █   █     ██  █████ █████   ██ ██ █ █ █ ███ █ █ ██  ██  █  █ ██   █     █ ██  ████     ██
█ █ █   █ █  ████   ███  █ █ █ █ █ ██  █ █ █   ██ █  ███  █  █  █ ██ █  ██  ███ ████    █        █ █ ██   █   ████ █   █ █  ██ ███   █   █  ██  █   █    ██  ███  █ ██   ██ █████  █  ██  █ █ █ ███ ███  █  ███   ████   █ ███ █  █   █ █   █ █ ███           █  ██   ██  █ ███ █   █ ██
██ █ █     ██   █        ███  █   █ █    █   ██████ ██     ██   █ █ █      ██     █ █ █  ████      █ ██ █   ██  █ █    ██  █ █   █ █ ███  █ █ █████ ██   ████  ███   ██ ███     ██   ███ ██ ███████ █ █ █  ██ █  ███     ██   ███  █  █  █   █ ██ ███  ██  █ █  ██ █  ██     █ █ █ █  ██
███ ██ ███    █ ██████ ██  █ █     █ ██   ██ █ ██   █  █    █      █   ████  █ █  ██   █ █████  ██ █ █    █        ███  █ █  █  ██ █  █ ██ ███   █  █  ██  █   █     █     ██    ██  ███ ██  ██ █   ██  █   █████ █  ████  █ █████  █   ███ ██  █  ██      █ █  ███ ██████  █████ ███ ██
█ █ █ ███   █   █ ██ █  █ █  █ █  ███      █ ██  ██   █████  █ █     █     █  █  ███   ███  ███ █    █  █  █ █   ██  ██ █ █    █   ███    ██  ████ ██      ████    ██ █ █ █ █  ██████ ██  █ ████   ██ █  ███ ███  ████   ███ █    █  █████        ██ █ ██   ███    █ ██   █  █     █ ███
█ █  ██ █   █   ██   █   █ █   ██  ███  ██  ███ █ █  █ ████ ██ ███ ██    ██  █      █   ████ █  █  ██  █ █   █  █     █ █ ██ █    █ █ ██  ██ ███ █ █   ██ ███ ██  █ █████  █       ██  █ ██  █  ██  ██  █     █████   █ █   █ ████ █ █ █     █ █  █ ██ █ ██ ██     ████ ████  ██ █   ███
█ ███       █ █ █ █      █  █ ██ █ ██   █ █ █  █ █ █ ████ ██  █   █      █  █  ██  █    █ ███████  █ █   ██  ███ ███ ████  ████    ██  ███ █ █      █    █  █     █      ██ ███ ██████ █   ██ █████  █ ██ ██ █  █  ██  █ █   █   ██   ███   █  ██ █   █ █      ██ █   ██      ███ ███ ██
█  ██     █   █     █   ████  █  █ ██      █  █   ██ ██ █ ██ ██ █████ ██ ██  █       ██ ███  ██  █  █ ████      █ ███ █████ ██        █ █   ███    ████ █ ██ █       █  █ █      █    █  █ ██ █  ██ █   █  █  ██ ████ ██     █  ██ █   █  █ ██ ███ █ █  ███      ██   █ ██    ██  ██   █
██ █  █   ████  █ █  █ ███ █████ ███     ██  █    █  ██    █    █  █ █ █  ████  ███ ███████ █ █ ██ ██ █          █       ██  ████ █ █  █  █ █        ███   ████  █   ██ █     ████ ██████  ███   ███     █     █      █ █     █   █ ██ █ ███ █  ███ ██ █    █  █ █ █    █  ██ █   ██████
█ █ █ ████   ███ █ █    ██  ██   █     ███ █ ███    █   █ █████ █ █████ █   ██    █ █          █     █  █      ███  █ █   ███    ██   ███ █ █ █ ██  █████ ██ █   █     █           █  █  █  ████     ██  ███  █       ██  █ █  █           ██ █ █   ██  ███  █  █      █     █  ███  █ █
██   ██ ██          ██ █ ██ ██          ██ ███  █ █ █  ██  █ ██ ██     ███  ███  █  █ █     █     █ █ █ ███ ███  ██ █  ████ ██   ████ █ █ ██    ██    █   ███  █    ██              █ █ █ █ █  ██  █    █   █ ███  ████   █      ██ █████      █ █  █ █ █ ███ ███ █         ██ █ ███   █
█   █ ███   █  ██ ██ ██ ██ █  ███ ██   █  ██  █ █    ██    █ ██ █ █ ██  █ ███ ██ █     ███ █ █ █  ██ ████████  ██ █ ████         █  █   ██ ██        ██  █ █ █    █   █   █     █     ██ █ █      ███ █   █  ██ █ █    █ █   ██  ██ ██ ██  ██ █ ███  ██       ██   ████  ████ █ █  █████
█ ██  █   ██████ █   ███     █ █  ██ ███  █     █    ██  ██ █    █  ██    ██ █  ██ █  █   ██   █  █   █  █ ██  ██ █    ███ █  █ █████ ██    ██ █  █ █    █  █                   ██  ████ █  █ █  █      ███  █  █   █ ███    █      ███ ███ ███   █ █ █   ███    ███  █████  █ █   ██  █
█    █  ██ ██  █    █ █████  █ ███ ██ █ ██    ███   █ █ █ ██  █   ███ ███    █  █   █ █ █  ██  █████████     █   ██  ████     ██   █ ██ ██ ██ █  █     █ ██      █ ████ █  ██████ ██        █  ██   ███  █       ████████ ████ ██   █  █ █ ███    █ ███      █ █       █  █  ██  █ ██ ██
██ ██     █  █   █ █    █ █  ██ ██ ██  █████████ █  ███ ████ ██  ██       ███     ██ ████  ███   █    █ █  █ █  ████  █   █ ██   █ █   █  █ █████ ██    ██   █    ██ █        ██      █ ███ █  █  █   █  ██  █      ██   █ ███ ██ █  █ ███ █     █ ██           █ █  █ ██   ██ ██  ██  █
███ █  █       █ █   █████   █ █ ██  █ ██    █ █ █   █ █  ████  █ ██ █ █ ███ ██     ████ ██   █   █       ██ █  █    █ ██   ██ ███  █ █  █ ██ ██ █  ██ █ █   █ ██ ██ ████ ██ █   █ ████ ██ ██   █ ███████ █ ██ ██ ███ ██ █   ███ █   ██  █  █ █  █ ██ █      ███ █████  ███  █ ██ ███  █
██ █    ███   █     █    █ ██   ███  ██        █  █ ██ ████ █  ██ █   █  █ █   █  ██   █   ██ ██    ██    ██ █ █  █ ██  █     ██  ███ █ ██  █ ██ █ ███ █████   █ █    █████ ████      ██ ██   █ █ ██  █████   ███    ███      ██  ██ █ █  █  ██ █  ███ █ ██ ██     █      █ █ █████ █  █
██   █    ██ ██ █   ███████ ███           █ ████ ██ █  █   █   ██ █ █ █ ██  ████ █  ██████          ██  █  █   ██ █  █ █  ████ █   ███ █  ███      ████  █ ██    ██ █ █████    █  █ ██  ██    █  █ █  █   ██ ██ █  ██ █    █        █    █      ██  ██ ████ █  ██ █ ██ ████  █ █    █  █
█  ███ █     █ █  ███ ███  █████ █    █ ██  █ █    █     ██   █   ████     ████  █   █ ██ ██   █ █ █    █   ██ █ ████ ███  ██████ █  █ █   ██ ████ ██ ██ █  █ ███ █ ███   █ █  ██ █ ██  █  █  █     █    █  ████ ██ █████  █ ███ █       █  ██  █  █  ████ █ ██  █ █ █ █  █  █  █ █   ██
█ █     █         █    █        █   █  ████  █       ██ █   █  █   ██ █ ████ ██   ████ ██ █ █ ███ ██   ██    █   █  ██ █  █  ██ ██████ █      ██  ██    █  ████ █ █    ███ ██   █  ███  █████ █   ███       ████ ███ ██  █     ███  █ █ █       ██   █     █  █  ██ █   █    █ █     █ █
█ █ ███ █ ██ ███ █ ██   █ █ █  ██ █ ███ ████     █ ██  ██  █  █ █   █ █  █ ██   █   ██   █ █  █  █    ██ ██  ██ ███     █ ██  ██  █  █ ██     █    █  █ ██ █ █ ██  █  ██████   █     █    █████     █ ██       █ ███   █ ███  █   █ ██  ███ ███  ████ █     █  █    █   █ ██   █   █  ██
█ ███ █     ███  ████    ██   █  █ ██        █  █ █   █ █  █████   █  █ ██  █ █  █ ███  ██ █         █ █ █    ██ ██  █ █   █  █  ███  ██ █  ██ █  █  █  ███  ██  ██ █ █ █ ██  ███       █ ██ █  ██ ██  █     ██ ██ ██        █      ████  █   ██ █  █  █   █ █       █ ████  █    ████ █
██ █ █  █ ██     █      █ ██   ██ █   ██  █ █ █ █   █ █  █     ██  ███   █  █████   ███ ████     █    ███   █ ███  █      █   █     ██ █      ████   ██        █ █    █      █ ██ █ ███ █  █ ██ ████  ██ ██ █    ███   █ █  █   █ █   █     ██ █ █ █  ██ ██      ███  ██   █ ████   █ ██
█  ██    ██   █      █    █ ██ ███ ███ █     █    █      █  █ █ █    ██    ███ ████   ████  █ █   █     █ █   █  █  █  ██████   ██ █  ██  █   █     ██ █ ██  ██    ██ █ █ ████   █ █  ██  █    ██ ██   █   █     █    █   █  █ ████ █ █ ██ █   █  █ ██   █   ██ █ █ █   ██   ████     ██
█  ██ ███ █ █ ██ █    █  █ █   █ █  ██   █ █ █ █ ████ ███ █ ███    █   █ ██  ██    ███  █  ███   ██  ██   █ ██ █████  ██  ███ ██ █   ██  █ █   ████   █ █  ██ ██████ █     ██     ██ █   █  █ █ ██  ██    █   █████   ██ █ ███  █  █  █ █ ██    █  █████  ███ ██  ██  █ ██          █ ██
█  █  █ ██ █ █ ██   █ ██        █  █  █     █ █ █ ████ █    ████ ███  █ ███  ██  █ █ █   ██  ██    █  █ █ █  █   ██ █ ███   ███ ████  ███    █  ███ ██ █  █   ██     ██  █   █ ███  █  ██     █      █    █ █ ██      █ █ █ █ ███  █ █      █    ██████     ██   █  █   ███      ██  █ █
█  █████   █  ██  █  ███ ██ █ ██  █████      █ ██   █   ████  █    ███       █ ██ ██  █   ██   █ ██  ██  ████      █ ██ █  █████ ██     ██  █    █  █   █ █ █████ █ ██  ██       █████ ██  █     █ ██ █      ██ █ █ ██ █ ███   █    ███ █    █ ███  ████    █  █  ███   ██ ██  █  █ ██ █
████  ███   █     ██ █ █ ██  ███████ █   ██  █  █ █  ██ █ ████   ██ ████ ██ █  █    █  █   ██ █  █   █ ██  █ ██    ███ █  ███████  █ ████████ █ █      █       █  █   ███  █    █ █ █  █████ ███     ██ █    █  ██ █    ███     ███     █ ██ ████  █ ███ █   █████ █   █      ██ █     █
██ █ ████  █ █ █ ██  █      █ █ ███  ███ █  █ █ █ █ █  ██     ███ █ █████   ██  █ ████   █ ██     █      █  ███   █   ██   ██ ████ ██       █  █████ █ █  ██   ███████  █ ███   █████  █  █   █    ███ ██ █      ██     ██       ██    ███ ██    ██ █         █ ██ ████ █ █   ██   ██  █
█  █   ████████ █ █  ██ █   █   █    ████ █   █ █ ██ ████  █    █     █   ███      █    █ █   █ █ ██ █ ██ █  █   █   █  ███   █    ███  ███   ██  ██   █  █ ██   ███   ███  ██ ███ ██   ████     ██ ███   █       █ █   ███ █ █      ███ █    █ ██  ███  █ █ █ █   █  ██ ██       ██████
█  ██ ████  ███ █       ██    ██    █  █ ████   █   ██ █ █  █  █ █ █   █ ██  █ █   █       █ █  █    ██ ███ ██ ███ ██   █ ███      █  █████ ██ ███████  █   █ █ █ █      █  █ █ ███ █   ██████         █    ███  █ ██   █    █  █         █     ██ █  ███  █    ██████  █  █ █    ██████
██  ██  █   █    █████ ██ █      █ █  █ ██     ██    █   ███  █    █  █ █        █ █ ███    █ ████  █ ███     █   █   ███   █  ██  ██ █ █ ████    ██    ██   █    █ ██       █    ██ ██  ███ █  █ ███ ███████  ███  █  ██ █ ██ ██ █  ███   ██   █    ██   ██   █   ██ ██  ██████     █ █
██ █    █ ██   ██   ██ █     █  █  ██  █   █  ████    █ ██      █ ███    ██     ██ █ █  █  ███ ██ █  ███       █  █ ████  █  ██ █   █  ██     █       ██ ██   ██   █   █    █ █ ██   █   █  █  ███ ███             ███  █ ██  ████    ██ ██ ██       █ █   █ ██ ██   ██  ██ █  ███  █  █
█    ██   ██  █ █  ██    █   ██ ██ █      █  █ ██   █ █     █  █ █  ██ █  ███  █  ██ ██  █ █    █     ██ █  ██   █ █ █  ███  ███ █  █      ██     █  ██ █ █ █ █ ██ █  ██     █   █ ████ █  ███   ██  ██ █████      █  ██  ███ █    █   █  █ █ ████ █ ███  █ ██ █ █ █ █   █    █ █ ██ █ █
███ ████  █████     █  ██ █    █     ██ █ ██  ███  █    █ █ ██ ███  █      █ █  █  ██ █  █ █  █  ███       ████ █ ██ █ █ █    ████  █   ██  █ ███ █   █ █  █ █ █  ██ █ █   █  ███        ███ █ █   █   ███  ██ ███ █  █ ██     █    ██ █   █  ██ ██    ███ █  ███   ██       █   █ █ █ █
█████   ██    █  ██      █   █   ██████ █    █    █ █ █ █ ██████ █      █         ████    █    █ ██    ███ ██  █   █  █ █  ████ ██  █     ████       █   █    ██ █  █ █       █████ █ ███ ███    ████ █ ██████ ██████ ███ ███   ██  █  ██  █ █  ███ █     ███   █   ██   ████████████  █
███      ██  █    █  █ ██   ███ █ █   ██ █ ██     █    █████ ██  ███ ██ █   ██    ██   ███   █ █  █  █ █ █ ██████ ███ █   ███ ████ ██ █ ██  █   ██    █  ██  ███ █ █ █████ █  ███ ██   █  ███ █████ █████ ██  █ █ █  █   ████  █  █ ██ ██  █    █ ███ █ █  █ █  ██ ██ █ ██  █████  ██  █
█  ██ ██  ██ █  █████  ██   ██████  ███ █   █  ██ ████ █   █ █ █ █ ███ █  █ █   ██  ██   ██ █    ████   █ █   ███  █  ██ █  █ █ █   █  █ ████  █  ████ ███ ██   ██   ████  █    █  █         █  ███  ██       ████ █████ █ ██  ██      █   ██  ███ ██    ██ ██ █ █████       █    █    █
████████████████████████████████████████████████████████████████████████████████████████████████████████████████████████████████████████████████████████████████████████████████████████████████████████████████████████████████████████████████████████████████████████████████████████
