████████████████████████████████████████████████████████████████████████████████████████████████████████████████████████████████████████████████████████████████████████████████████████████████████████████████████████████████████████████████████████████████████████████████████████
███   ██ ██ ██  ███ ██   ██       ███   █ ███     █ ████ █  ██   ██     ██       █ █ ██ ██████   ███   ██ █   █ █ ██   █     ██ ███   ██ █     ██  █ █ ██  ██ ███   ███  █ ██ ███  █████   ███ █  █ █   █  █ █  █       ██  █   ██     █  ████ ██████  █  ██     ███  ██  ██  █   █  █ █
██ █  ██   ██      ██ ██ █  ████  █  █████ █ █    █ ███████████  █  ██ ██   █   █ ███   ██ █   ███  █ ██ █ █  ███  ███ █ █  ██ ██ █ ███ ██    ████    █ █ █ ██ █ █████ ████  █ █    █     ██ ███    ███  ██  █       █   ████ ████ ██  ██ ███ █   ██   █ ███       ████ █  █  ██  █ █  █
█   ██   █  █     █    █  ██     █ █ █     █████  █ ██     ██ ██  █ ██ ███  █  ███   ███    ██  █ █  ██████████ ███████ ███    █      █  █████        ████  ██ █ ██ █  ██     █    █ █      ██ ███   █  ██  █   ██    █ █ █    ███   █  ██ █████ ██    █  █ █    ██ █   █   ███  █   █ █
█     █ ██ █ ██    █  █ █ ████  ███  █   ███████   █  █ ██ █   ██ █   █     ██  ██     █ ██     █   █ ████ █   █  █ █  █ ███   █ ██ █ █  ██   ████     ████    ███████     █ █ █    █ █  ███  █  █ █  █ ██    █████ █  █████ ███ █ █  █  █ ██    ██  █  ██   ██ ██   ████  █  ██ █  █  █
██     ██     ███ ██ █████   █ █ █  ███  █  ██   ██     ██  ████   █    █ █ █ █ █     █  █  █  █ ███ ██ ██ █   ███  █           ██  █    ██  █    █   █ █ █ █ ██    █ ██ █       █████    ███    █  ██   █  ██     █  █     █  ██   ██   █ █ █  █ █  ████    █  █  ████ █ █  █ ███ ███ █
███    █  █     ████████ █   ███ █     ██   ███ █ █ ███ █ ██ ███  █  ███   █    ████  ███ █   █   █ █ ███  ███   ███  ██  █  █    █  ██ ███ ████   ███     ██ ██ █ █ ██   █ █    ██   █   █ ██ █ █ ███ █  ███   █   ██    █  ██   █ █ █ █ █    █  ████   █ █         █ █  ███  ██  █   █
█████  ██  ██ █    █  █ █ ██     ██ █   ██ █ █   █  ██   █ █    ██   █  ██     █ █    █  █ █  █ █     █   ███   █  ██  █   ███ ██ ██   ███████  ██ ██  █ ██ █ █  ██ ██ █ ███ █ ██   █ █      ███ ███    █ █ ███████ █ █  ██ █ ███  █  ███   ███      ██ █ ██     ███ █ █    ████   █ █ █
█ █ █ █  █     ████    ███    ███   █ █  ███  █   █ ███████ █ ███████          █████     █    ██     █   ██  █ █████  ██   █ █      █  █████   ██ ██ █ █ █ █   █ █  █   ██ ██ █████ █   █ ████  █  █   ██ ██   █   █ █  ██ █  █ ██    ██   █   █    █   █  █ █ ███ ██ █ ██   ██    █████
█  ██ █ ██  █ █   ██      █   █  █    █   █   █  █  ██   █         █ ██   ███ █ █ █  █████  █  █  █  ██ ██  █  ███   █  ██    ███  ██   ██  █ ███       ██   █ █ ██ █  █  ██   █ █  █ ██  █ ██ ███  ██ ███ █    █ █ █       █  █ █  █   ██     ███ ███ █ ██ █  █  █ █ █       █ ██   █ █
███ ██    █ █ ██  █ █ █  ██ █     ██      ████ █ ████  ██           █ ████   ██ █ █ █████ █ ████  ██ ██  ██  █    ███  █  ████    ███████      ██  █ ██  █  █ █ ██   ███ █  █    █ █ █   █ █  ██  █ █ █ █   ██ ███ ██ ██   ██  ██  █████ ████ ██   █      █ ██    █  █████ █       ███ █
██  █ █  █ ███ ██  ██ █    ██    █    ████ ██  █    █ ██ █   ██  ███ ██ █ ███  █████ ██ █              █ ██    ███  ████ ██  █  █   █    █ █   ██   ██ ██   █ █ █ ██ █ █  █ █  █ ██  █ █    ██  █  █ ██   ██   █ ██ █   █ █ █ █████    ███   █ █ ██   ███   █ █ ███ █  █  ███        █ █
█     █ █ ██  █ █  ██ ████ █ ██ █ █  ███ █ ███    ██  ███ ██  █ █ █   █  ██   █    ██   ██ ██  █ ██  █ █  ██ █ ██ ██   █  ██    █  ██  █     █ █ ██ ██   █    ██ ███  █   █ ████ █   ██  ██    █████     ██ █  █    █████ ██ ██  █ ██  ███         █   ██  █    █   █  █  █  █ █   █████
███ █     ██    █ ██  █ █  █    ██ █ ███ █ █   ███  █    █ █  ██ ██ ██   ██      █   █ ██████  █ █ ███ ███ █ ███  █ ██     ███ █ ███      █ █ █ ███ █ ██    █   ██  ████   ██ ███      ██      ██  ███ █    ███    █████ ██ █  ██   ████ █ █ █     █    ██  █ ██   █     █ ███ ████ ██ █
██ ██    ██ ███   █  ██  ██ █ ██  ███  ██ █     █    █   ██  ███  █   ██  █  ███ ██ ██████   █ █████  █  █   █ █     ███ █    █  ███  ███ █ █     █   █ █     ██  ██  █  ██ █     ████ █    █ ██ ██    █    █ ███ █ █ ███ ███     █ █  █ █   ████      █  ██    █    █ █ ██ █  ██      █
███ █  █  ██ █ █    █████  ████ █    █  ███     █ ██  █    █  █ ███ █ █    ██████ █      ██  █████     █   █   ██  █  ██ ███ ██   ██   ███ █    ██  █ █ █████ █ █   ███ █   ████    █ █ ██  ██   ██     █        ████████    ██ ██    ██     █    ██ █ ██   █  █  █  █ ██     █ █ █ ██ █
█   █  ████     █ ███ ██ ██ █  █   █       █     ████   ████ █  █ █  █ ██ █   ██  ██  █  ████    █   ███   ███  █ █     ██   ██ █ █  █   ██   ██ █  ██ ██ ███    █        ████ █  ██   █     ██ ██    █ █     █  █  █  █  █       █ ██ █ ███ █ ██ ██   █    █     █   █ █ █  █    █ ████
█ ██     █  ████ █    █  █  █   █ █    ██ ███████ █ █    ███ █ ██  █ █  █ █  ██   █████ ████    ███ ██   █    ██  █  ███ ████ █  ██  ██ █   █ █ █████  █     █  █ ███    ███    ██ █ ██   ████ █ █ ██ █████  ██ ██        ██   ██ ████   █   ██    █ ██ █ ███        █ ██████ ███ ████ █
█    █ ████        ██ █     █████   █  ███  ██ ██ ██  █  █ ████  █    █     ██  ████ █████ █   █ █   █   █ ███████  █  █    ██ █ ███ █     ██  █  ██ ███ ██ █ ██ ██    █   ██   ███  ██  ███ █  █  ███  ██ █ ██ ███  ██  █  ███  ██ ██ ███   █ █ ███ █   █ ███ █ ██  ██  █ █ █ █ █  █ ██
██   ██ █ ███  ███ █     ██  ████  █     █    █   █ █ ██  █  ███ ████ █ █ █ █    ████ █  █  █  █  ███ █   █  █ █ █ █ ██ █ █ █  ██   ████ ██   ██ ██    █ █   █ █ ██  █  ████      ██ █  ██  █████      █ ██  █ █  █  ███ ██████████  █ █  █ █ █ █ █ █     ██ █████ █ █  ███ █  █ █     █
█  █ █   ██ ██  ██ █  █ █████ █ █    █ █  ██  ███ █████ ███ █  █  ███ ██ █   █ █  ███  █     █  ██ █       █ ███ █ ███   ██ █ ██ █  █  █  ██ █ ████ █  ██    ██ ████    █    ██   █ ███   ██████████ █   ████  █  █        ███    █    █ █       ███ ██ █  ██ ██         █ █████ ████  █
█ █  █  █ ██ █   █ █  █ █████  █ █ █ ████  █        █ █     █  ██  █       █ ██ █ ██  ████ ██  ██ █  ██ █ █████ █ ██ █ █ ████    █  ███   █ ███       ███   ███ █       █ █ ███   ████  ██████   █   █  █ █   █ █     █  █  ██ █ ██  ███ █  █   ███    ███ █ █  ██ █ ██████  █     █ ███
█ █ █   █     █  ██ █ █   ██     ██ █████     ████     █ █ █  █ ██  █ █ ██████     █  ██  █  ███   █ ████    ████        ██          █ ███ ████ █     ████  █   █ ██ ███ █ █    █   ██ ██   █  ██████   ███      █   █  ████    ██  ██  █       █   ██ █ █ █     █  █████   █ █ █      █
█████ █  █ █ █   █████ ██ █     █  █ █  ███    █████ █   ████   ████ █ ██ ██     █ ███████ █ ██ █   █ ████  ███   ███████ █ ██ ██████ ██ ██ █ ██ ███   █ ████   ██  ████  ██ ████    ██ ██   █ █ ██    █ █ █            █ ███  █   ██   █ █ ██  ██ █  ████ ███  █ █   █   █ ██   █ █ ███
███ █  █     █   ██ █ █  █ █ ████████ █ ███     █  █  ██ █  ██ ███      ██     ██    ███ ███ ██  █    █   █ █ ██ █  ██  ██   █  ██  █    ██ ██ ██  █ ██ █ ██   █     ███   █  █ ██ ██ █ ███ █  █ ██   █     █ █  ███ █ █     █ █  ██ █████  █ ██ █   █   ███     █ █   █ ██  █ █     █ █
██    █  █  █ █ █  █  █   █   █     ███████   █   ███ █  █ ██ █ █     ████ █   █ █   █   █  ██  ███  ███ ██  █ █     █ ██   ███   ██ █ ███  █ █ █ █████  █  █ ██ █         ██   █ █  ██    █ █    █ █ █   █             █  █     ███ ████ █ █  █ █ ██  █  ██  ██ ██  █        █   █   ██
██      █  █ █  ██     █ █ ██ █ █ █  ██  █  ██    ███   ██ ██ █ █ █ ██    ██ █ █ ████       ███  █ ███ ██ ██    █ █ █ ████  ██  █ █  █████ █   █ ██   ██  ██ █ ███ █ █  ██  ██      █   █  █     █   ██ █ ██  █ ██ ██ █  █ ██ ███  █ █████ █     █ ███   █  █  ███████ ████ ███     ██ █
█    █  ███ █   ███   █    █  █  █ █████ █  ██ ██  █         █ ████  █  ███    ███ ██ ██    ██ ██  ███  ██ █ ██   █████ ██  █   █ █        █  █  ████  █   █   ██    █  ██ █   █████    ██  █████  █   █ █   ████   ██ █   ██  █ █ █ ███ █ ███ █ █       ██████ █      ███ ████     █  █
█   █    █      █████  ███ ██    ██ █  █  ███   █████ █ ██ ██ █    ██    █ █ ██ ██ █  ███ █  ████ █   █   ██ █  █     █ ███ █     █  █  █   ██  ██    █     ████  ██  ██   █  ████ █  █ █  ██ █ █        ███  ██ ██  █  █    █   ████   ███ █ ████  ██ ██ ██ ██  ██ ██   █ ██████   █  █
██ ███  █  ████ █ █     █   ████       █    █  █ █  █  █   █   █ ███ █ ██  █    ██ █ █  ██ █  ███ ████ ███   █ █ █  ███   ███  █     █    ██ ████  ███  █   █  ██████ ███  █████ ██ █ ████████  █     ██     ██   ██ ██    ██    █████  ██  █ █ █  █ ██ ███  █ █ █    ████    █  █  ██ █
█ ██ █  █   █  █████  █  █ ██ ███   █    █   █ █  █ █  ███  █ ██  ███    █      ██   █ ██   ██ █  █  ██         ████ █ █ ██    █ █ █      █      █    █ ██  █  █   █████ █   ██ █ █  █  █ █  █    ██      ███ █ █   █ █   ██  ██    █  ███ ████ █ ██  █ ██ █    █ █  ███████     █ █ ███
█  ███  █ █     █████  █  ██ █   █ █  ██     ██ ██     █  ██  ███ ██████       ███ █ █ ██   █ █ █ █          █ █ ███ ██   █ ███    █ █  ██ ██ ████  ██    █  ██  ██ ███  █  █    █   ██   ██  █ ███ ████  ███  █   ████ ██    █   █  █ ██ █  █    ████   █  █  █   ██ ███  █ █  █  ██  █
█ █  ██ ██  █ █     ███   ██   █ ████  █     █    ██ █  █  █████  ██ █ █ ██ █     ██   ██   ██    █ █ █ █  █ ██ ██  █ █   █    █    ██ ███████ █ ██  █████  ██  █   █  █ ██   █     ██ █  █   █ ██  █ ██  █        ██ ██     █ █ ██  █   █ █ █ ███    █  ███   █ ██  ██ █████ █ ███ █ ██
███ ██ ████ █   ██    █  █ ███ █████ ██  ███ ██  █    █ █  █   █████ █ ███ ██  ████   █ █     █   █████    ██ ████ ██   █ █            ███ █  ███    █ █  █ █   ███  ██  █     █ █    █  █ █   █    ███   █   ██       ████ █   █████  ███ █ ██ █ █   █  ███  █ █ ██     █   █ ██   █  █
██████ █ █    ██      █  ████ █       █ █      ████ ████ █    ██   █  ██ █  █ █  █     █ ██ █  ██ ██ ████ ███   █  █████     ███     █  ███  █ █ █    ██  █         █  ██  █ █ █ █ ██████    █ █  █ █ ██ █████ █  ██  ██ ███   █ █ █ █ █  ██      █    ██  █ ██   █   ██  █ ███  █ █████
██  ██ █     █         ███ █ █ ██  ██  █    ███ █  █    ██████ █ ██   ██  ███ █ █  █      ██ ███   █  ███ █ █     █    █    █  █ █ ███   █  █  █  ██ ██ █       ██     █ █ ██  █   ████   █    ███ ██ █ █    █████ █ ████  ███ █   ██    ██  █  ██  █   ██ █ █  ███ ██ ██   █   ███ █ ██
██ █████ █ ████  ██ ██   ███ ██   █  █ ██     █  █ █ ██   █ █  █    ███ █ █     ██  ██ █ █████  █ █     █    ██ ███   ██  █ ██  █ ██ █  ████    ██ ██ █       █  ███ ███ ██ █  █ █  █ ██  █  █   ███  █ █  ██     █      █  █ █  █  █  █ █       █  ██ █ █ █   █ ██████ ███ █████   █  █
███ ███  ██ ███  █████ ███   ██     ████████ █ ███     ███ █  █ ████     ██   ██     █  █    █  █████  █ ████    ██     █ █ ██  █   ██  █████ █ █ ██ █  █       ███  █████   ██    █ █     █   █  ████ ██   █ ███   █ █    ██ ██  █   ██  ███ ██████  █  █ █   █      █   █████ ██  ████
█    █ █  █  █ █   █ █   █    █ ██    ██      ████  █ ██ █ █ █ █  █     ██ ██████  ██   ███ █  ██  ██ █   ████   █       █ ██  █   █ █   █ ███     ██ █ ███ █ █  ███ ██ █    ██   █   █  █ █    █  ███ ██    ██  █████  ██     █ █    ███  ██ ███   █ ██  ██ ██  █ █  █  ███ ███████   █
██   █ █  ███  █  █ ██ ██ █ ████     █ █   █████████   █  █    ███ ██   █ █ █        ██     █    █    ███        ███       █  ████ ████ █  ███ █  █     █   ████ █ █  ██   █ █  █    █ ██     █  ███  █       █ █ ███  █  ████  █  █ █ ██  █  ████ █       █ ██  ███  ██   █ █ █ ████  █
█ ████ █       █ █   ████    ████     █ ██ ████ █  ████ █ █ ███ █ █  ███  ██████ ███    ██ ██   ██   █  ███             ███ ██ █ █ █ █  █  █  ███████   █████   ███   ███ ████   █  ████ █ █  ██ █  ███  ██    ██  █ █████    █   ███   █ █   █  ██  ███     █ █ ██     █████    █  █  █
██ █   █       █  ██  █   █   █  █  █   █   █ █  ██ ██ █ ██  █  ██  ███ █    ██ ███ █ █  █ ██ █  ████ ███  █ █ ██     ██  █   █  ███ █ █ ██  █  █ █  █ █  ██     █ █  █ █  ████    █  ██   █  █   █  ██ ███      █   ██ ███ █   ██   █     ███   ███ █        ██  █  ███ █  ██ █   █   █
██   █   ██   █    ██ ██████ ██  █   ███ █████ █  █ █ █ █    ███ █    █  ██  ██ ███ ██   █ ██    █  █  ██ █     █ █ █   █ █     ██   █  █   █  ██     █ █ ██ █    ████        █  ██  █      ██ █  █ ███  ██   ████ ████ █ █ █████  █ █      █ ████ ███    █      █   ███ ███     █  █  █
█ ██ ██ █  █ █ ███ ██    █ ███ █ █ ███ █   ██   ██  █   █  █    █  ████  █ ██████ █ █ █   ███ ████        ███ █   █  ██ ██ █ ██ ██  █  ███ ██ █ ███ █  ███  ██ ██ ██ ██   ███  █      ██   █             █  █      ██  ██    ████ █  █ █    █ █     █  █  ██         █ ████      █  █  █
█    █ █    █ ██    █    █ █    █  ███    █ █  ██ ███    █████    █ █  ███ █   ███ █ █████  ██  ████  █    █ ██    █  ███ ██     █ █     █ █ ██  █ █  █ █          ██  ███  █  █ █    █ █ █ █ █  █ █  █  █ ██ █    █    ██     █  ██  █   ██     ██ █ ████  ███   █    █    █    █   ███
███ ██ ██ █   █ █ █ █████ █ ██      ██   █    ███  ██   █ █   ███   █  █ █   █  ████   ██████   █   █   █ █ ██   ██  █ ██    ██    █    █     █ ██ █  ███  █ ██ █  █ ██  ██          ████ █  █ █    ██   █ █  ██   █ ███   █ █   █  █    █ ██        █ █  ██  █ █ █    █ ██  ███   █  ██
███ █ █  █  ███  ██ ██ ██ █            █  ████   █████ █   ███ █     █ ██      █   ██ █        █ █ ███ ██   ██ █  █      ██ ███ █  █ █     ███████   ██ █    ██ ███  █  █ █████  ███ █ ██ █  █ ████      █   ███ █ ██    █  █ ███ ███ █ ██ █ ███  ██   ██ █████    █   █  █  ███  ███ ██
██      █  █ ██ █ █   ██  █  █ ██  █  █  █  █ ██ █ ███     █   █ █ ██   ██ █ █     █ █ ████ ███ ███ █ ████   ██  ██   █ █  █       ██ ███    █   █ █    ██ █  █   ██  █  ██      ██ █ ███ ██   █ ███ █ ██   █████       █ ███  █   █    ███ █  █  ██ ████  ███     █ ██████  █ █  █ ██ █
█ █ █ ████   █ █ ██    █ █ █   █  █ █  █ █████   █   ███  ████          ██     ██     █  ██    █ ██    █ █ █ ███        █  █    ███   █  █    ██  ███ ██      █ █    ██ █     ███     ██ █ ████      █ █  █ █ ███ █      ██ █████   █ █ ██   ██  █ █ █  ██  █   █ ███ █ ████ ███ █  █ ██
█     █ ██   ███ █ █  ███  █     █           █ ██       █ █   ██████   ██  ██████  █  █    ██        ██ █ ███  █ █  ██ █    █ ███ ███       █   ██   █   ██       █ █  ██  █   ██  █       █      █  ██  █ █ ██ ██  █   ██  █ █  █ █ ██ █     █████ █████ ████ █  █     █    ████    █ █
█████ ██ █   ██    █ █   ███  ████ ██ █    █ █ ███  █  █    █ █ ███ █  ███ █  ██   █ █████  ████    █ ██ ████ ████    █  ██  ██ █ █   █   ██ █  ██    █  ██ █   ██████ ██    █     █   █ ████  ██ █ ██  ███    ███   ██  ███ █ █  █  ██  █   ████ ██   ██ █ ████ █     ██ █ █ ███  ██ ██
█ ██ ██ █   █ █  ████ █   ███      ██ ████ █ ████ ██ ██   ████ ██ █  █  █   █  █    ██ ██ █  █  ██     █████   █ █   ██████ ██ ██  ██████ ██  ██  ████ █ █  ██ ██   █ █ ███  ███ ███ ████  █  █ █ █  █ █ █ █ ██     ██      █ █ █   █  ██ █ █████  █    ██   █ █    █ ██   █ ████  ██  █
███ █   ██ █   █ █   █  █     ██      ██ ███ █ ███  ██████████ ██  ██  ██ █ █    █   ████ █   ███    ██   █   █ █  ██  ███  █ ███ ██     ██  █ ██     █ █   ██  █ █ █  ██ █ ██ █ █   ██ █ ██    █  █  ██████      █  █     ██   ███   ██  ████   ██ █  █████        ███ ███    █ ██ █ ██
█ ██    █ █   █    █ █  █ █ █  █    █ █  █  █    █        █  ██  ██   █  █    ████████ ██  █ █ ██ ███   ██ █ ████  █   █   ██ ██████ █  █   ██    █  █ █  ██ ██     █   ██    ██ █ ██    █    ██    █      ██   █ ██████   ██  █ ██ ███     █ ██        █   ██  █ ██ █ ██ █ █ █  █   ███
█ █   █████ █  ██ ███  █  ████  ████  █ ███ █ ██ ███ ███ █ ██  ███ █    ██      █     █ █ █ █ ███  █   █   ████ █  █   █ █ █     ████ ██ █ ██  █   █   ██      ██    ██ █ ██ ███  ██   █ █ ██████ ██ █  ██    █ ██  █ █  ███  ██ █ ███ █  █   █       ██ █  █ ██ ██  █   █   ██ █ █    █
██    █  ██  █ ███ █ █ ██  ███      █ █ █ ███  █   █      ██ █ ██          ██          ████  █ ██  █     ██ ██ █  █ ███  █ ██ ███ ██    █ █   ████   ██  ███   █ ████ ██       █ █   █ ██      ██    ██    ██ █    ██     █ █    ███ █ █  █  ███  ██ ██   ███   ██ █ █     █   ███ ██  █
█ ██ █   █ ██   █ █  ███ ██    █  █ ██ ██ █ █      █ █  █ █ █  █  █  ███ ██    █ ██ █████   █ █ █  █   █  ████ █   █  ██ ██  ██ █  █   █  ██       ██ █     █   ██   ██ ██  ████  ██ ███        █  ██   ████    █ █████ ████ █ ██  █  ████ ██ █  █ █ ██  █ █  █     ██  █ █ █  █       █
██     ██ ██  █  █   ███   ██      █   █   █    █ █    █ ███ ██  █  ██ █   █ █ █  ██  █ █ █   █ █  ██ █  ██    ████      █ ███     ███   █ ██ █   ██   ███ ██ █       █ ████      ███    █  ██    █     █   ██          █   ██    ████  ███ ██ █ █ █████     ██    █ █ ██   █  ███ █  ██
██  █████ ██ █ ██ ██ █ █ █  ██  ██  █   ██  ██████     ██  ███ █       ███   ██████ █ ███ ████████████   ██   █    █    █   ██ █████   █  █   █   ██  █ ██ █ █ ██     █   ██   ██ ██ █        ███ ████ █  █  █  ██    █   ██  █  █   █ █ ██    █ █     ███  ████ ██ ███ ██ ███  █████  █
██ █ ██ █ █   █   ████ █  █ ███ ██  ██     ███  █  █  █ █   ██ ██         ███ █ █  ██   █   █  █     ███   ███████  ███  ███   ██ █ █       ████  █  ███  ██  █ ██ █  █ █  █  █ ██   ████    ███   █   ██ ██  ██  █  █    ██   █         █ █    █  █     ████ █ █  █████  ██ ████ ██ █ █
██ █   ███        █   █ ██ █  █  █  █          ██ █   ██ ██  ███  ██        ███ ███ █  ████ █  ███  █████  ███  █  █  █  █   ██ █  █████ ██    █  ██ █  ██ █  █ █   █  █████  █ █ ██ █  █████      █ ██████   ███ █ █    ██     ████ ██ █ ██ ███ █       ████  ██ ██ ███   █ ██  █ ██  █
█    ████  ███ █ █ ███ █████ ██ ██   ███   ██  ██████        ██ ████ █  ██  ██ █  █ █████   █      █     █    █  ███  ████   █  █  ██      ██   ██  █ █████ █    █     █  █  █ █  █ █ █ █  ████ █ ██  ██ ██ █  ██ ███    █  █      █ ██   ██    █ █  █ ██ █   █   █    █  ███    ██ ██ █
█      █   ██  █ █ █    ██  ██ █   █ █ ███ █     █ █  ███ █    ██ █ █  ██ █     █ ███  █ █   ███  █ █ █ ███   ████ █ █  ██ █  ███   █ █ █    ██ █  █ ██   ██   █   █  █ █  ██ ████   █ █   █ ███  █ █    █ █  ████  ████   █    █ ██ █ █    █  ██ █  ███ █ ██ █  ████  █ █       █   █ █
█  █ █  █ ██ █ █ █   █  █   ██████  █ ██ █  █ █  ██   █████████ ███   ██   ██ █  ███   █   █████ █ ██   ██ ████ █  ██ ███ █   █   ███  ███  █   █ ██ █            █   ██  ██ ██ ██ █ █   ████ █ █ ███ █ ███ ██     ███  ████          █   █ ██    █ ████  ██   █  █  ██ █ █ █ █  █ ███ █
█ █    ███      █   ██████ ██ ██████ █     █  ██ █ █  ██      █ ████  ██  █ █      █ █   ██       █  █   ██   ██  ██  ██     █    █     █         █   █   ██ ███ ██     █   ███ ██ █ █  ██ ███ ████   ██  █ ██ █  █ █  ██ █             ██      █ █ █   ███ █    ███   ███  █  ██ █  █ █
███ ██  █ █ ████  █    █ █ █ ██    ███  ██  ███ █ ███     ██ ██  ██ █  █ █     ██ █  █ █       ███ █ ████   █ █  █         ██ █  ██ █   █ █ █ █  ████ ███    █  █  ██  █  ███  █ █ █  █ █ █    ██ █ ███ █    █   ██  ██   █   █ ██ ███   ██ █   █ █  █  █  ██ ████  ███ █  ███  █    ███
███ █  █ ██  █  █ █     ██     █ █   █    █    ██   ███     █  ██ ████ █  ██        █ ███ █ ██ █ ██  █████   █     ██      ███   █    █    ███ █ █ ██ ███ ███       ██  ██   ██   █ ██ ███ █ █  ██ ███ █ ██    █    █ ████ ████ █ ███  █   █  ███ █      █  █ ██    ██     █  █ ██████ █
████████████████████████████████████████████████████████████████████████████████████████████████████████████████████████████████████████████████████████████████████████████████████████████████████████████████████████████████████████████████████████████████████████████████████████
