██████████████████████████████████████████████████████████████████████████████████████████ █████████████████████████████████████████████████████████████████████████████████████████████████████████████████████████████████████████████████████████████████████████████████████████████
████████████████████████████████████████████████   ███████████████████████████████████████  ████████████     █████████████████████████████████████████████████████████████████████████████████████████     ████      ████    ████████████████████████████████████   ████████████████████
███████████████████████████████████████████████          ███████████████████████████   ███   ██   █████       ██████████████████████  ██████████████████████████████████████  ████████   ████████████                               ███████████████████████          ███   █████  ██████
██████     ███████  █████████████████████                 ████████████  ████████████    █          ████       ███████     ████  ███    ███████████████████████████  ███████     █████       █████████                                  ███████████████████                  ██     █████
████        █████    ███████████████████           ██      ███████████  ████████████               ████       ██████                     ████████████████████████    █████       ████        █████████                                  █████████████████        ██                 ████
███         █████    ██████████████████           ███        ██████     ████████████                ██        █████                       ████████████  █████████    ████         ██          ██████████        ██                       ███████  ██████        ████                ████
███        ██████     █████████████                ██         ████       ███    ███                           ████                        ██████   ██     ██  ███    ███                      ███████████      ███████   ██                        ████         █████              █████
███      █████████       █████████                            █████                                           ████                    █████████               ███    ███                       ███████████     █████████████                        ██          ███████            █████
██       █████████        █████████                           █████                             ████         █████                   ██████████               ████   ████      ██           ██  ██    █████     ███  ███████                                    ████████            ████
██        ███████          ██████████          ██             █████          ███               ████████  █████████                   ██████████               ████   ████    ██████        ████        █████          █████            ██  ███                  █████████           ████
█          █████               ███████        ███████         █████         █████████████     ███████████████████              ██    █████████      ██         ████   ██    ████████       █████        ████                    ██████████████                  ███  ████            ███
█                  █████         █████        █████████        █████        ██████████████    ████████████████            ██  ████   █████████     █████        ███         ████████        ████         ██                    ███████████████                  ██    ██             ███
█    ██           ███████         ████   ██    █████████       █████        ██████████████     ████    ████              █████████    █████████    ██████                    ██████           ██                               █████  █████                     ██                   ███
██   ██           ████████         ██   ████  █████████████     ████         █████████████              ██               ████████      ██  █████  ████████                    ██               ██                              ████    ███                      ██             █     ███
███████            ███████              ████████████████████    ████         █████████████              ██               ████████           ████  ████████                                     ███                        ██   ████                                           ████  ████
████████           ████████             █████████████████████  ████          █████████████              ███             ████████             ███  ███████             ██                      ████             ████            █████                                           █████████
████████            ████████             ████████████    ██████████          ██████████████             ███             ████████             ███  ███████            ███                      ███             ██████            █████                                           ████████
███████                ██████             █████████       ████████           ██████████████                              ███████             ████████████             ██            ██        ███            ████████            █████                                           ███████
██████           █       ███   █████           ████       ████████          ██████████████       ██                       █████              ███████████                            ██        ███           █████████              ████                                          ███████
██████          ███            ██████           ███      ████████         █████████████          ██                        ████             ███████████                                       ███           █████████                █                                           ███████
██  ███          ███           ██████            ██    █████████         █████████████                              ███   █████             ████████         ████                              ███  ██           ████                                                            ███████
██   ██          ███            █████             █   ██████████         ████████████                               ███████████             ████            ██████                               █████            ███                      ███             ███                    ██████
███  ███         ███              ██       ███        █████████           ███████████                               ████████████             ██           ███████      ████                       ████            ███             ██        █              █████                   █████
███  ███         ████                      ███        █████                █████████                                 ██████  ███                         ██████       █████           ██           ██                            ████                       █████                   ████
██   ███          █████                    ██         ████                  █████                                █    ████    ██                 ██       ███         ████          █████                                       █████          ██            █████                  ████
██   ██            █████                              ████                   ████                               ███   ████    ███   ███         ████                  ███          ██████                                       █████         ████           ███████                ████
██   █             ██████                              ██                    ███                                ████  ████    ██████████        ████                   ██         ████████     █                               ███████        ████          █████████               ████
██                 ███████               ██        █                         ███                                 ██████████    █████████         ██                    ███        ███████████████                              ███████        ████          █████████          █     ███
█                  ████████           ██████      ███          ████          ███                                  █████████     ███████                                ████        █████████████     ███                      ███████          ████         █████             ███     ██
█                 ███   ██           ███████      ███          ███████       ███                                   ████████     ████                                   ████           ██████████    █████        ██           ██████            ██████       ███             ████     ██
█                 ███                ██████      ████           ███████      ███                       ███          ██████       ██                                   ████             ██████████  ██████       ████          █████              ██████      ███            █████     ██
██     ██                            █████        ██            ███████                               ████            ██                                               █      █         ███ ████████████        ████          █████               █████       █              ███      ██
███   ███                             ████                      ██████                               ██████  ███                                                                        ██   ██████████         ████           ████               ████                               ███
████████                              ████                      █████                                ████████████         ██                                ██                         ███    ████████          ███      █      ██                ████                               ███
██████                                ████                      █████                                 ████████████       ████                              ████                       █████                     ██      ███                       █████                              ███
█████                                 ████              █████   █████                                  ███   █████      █████                              ████                      ██████                             ███                       █████                              ███
████                         ████      ██            █████████  █████                            ██           ████     ██████      ██                      ███             ████     ████████                             █                         ████                              ███
███                      ████████████               ██████████  █████                           ████           ██     ███████     █████████                              ███████    ████████                                                       ████                             ████
███                      ████  ████████             ██████████   █████                    █      █████               ████████     ████████████                           ███████     ██████                                                        ███                              ████
███          █           ███     ███████            ███ ██████   ██████                  ███      █████              ███████     █████████████                           ██████       █████                                 ██                     ██                               ████
████       ████                   █████████         ██   ██████  ██████                  ███       █████             ██████      █████████████         █                    ███        ███                                  ██                                                      ████
█████    █████                     ████████             ████████████████                           █████             █████        ██████   ███                                  █      ███                                  ██                                ██                ████████
██████  █████                       ██████    ██        █████████  ███████                        ██████             █████         █████    ███                  ███           ███    ████                          ██       ██          ██                  ███               █████████
████████████                         █████   ███        ████████     ██████                       ██████            ███████         ███      ██                 █████           █    ████                          ████      ███        ████                ████               █████████
██████████      ███        ██         ██████████        ████████     ████████                      ████    ██      █████████                                    █████               ███              ███          █████      ██████████████     ██         ████                 ████████
█████████       ███       ████         ████████          ███████     █████████                             ███  █████████████                                  ██████              ███           ████████        █████        ██████████        ██████    ████                  ████████
█   ██████       ██       ████         ████████              ███    ██████████                             ██ ███████████████                                  ██████             ███           ███████████      ████          ██████           ███████  █████    █            █████████
█    ████        ██        ██         █████████    ███        ██     █████████                                  ██████████████                                  █████             ██            █████████████     ██            ████            ███████  █████   ███           █████████
█     ██        ███                  █████  ███████████       █           ████                                   █████████████   ████      ██████                ████                            █████████████                  ███              ██████   ████   ███            ████  ██
█              ████                  ████    ██████████      ██            ██                        █            ███████████   █████     ████████                ██                            ██████████████                                   ██████    ████   ██                   █
██             ███                   ██      █████████                                              ███            █████        ████      ███   ███                                             █████████████                                    ███████    ███   ██                   █
██            ███                            ████████             ███                               ███    ███                   ██        █     ███                                           ██████████                ███                     ████████  ████   ███                  █
██            ███                            ███████             █████                       ██    ███      █                                     █████                                         ████████          ██      █                      ██████████████  ████████             ██
██                                            ████               ██████                     █████████                                              █████                                          █████           ████                  ███       ████████████   █████████         █████
██                                                               ██████     █            ███████████               ████                            ████                 ██                  ██      ██            █████                █████           ██████     ████████        ██████
██                                                                ██████                ████████████               █████                           ███                  ███                ██████                   ███          █     █████            ███           ████         █████
██      ███                                                        █████                █████████████               ████  ██              ██      ███     ███           █████             ████████                              ██      ███                            ████         ████
██     ██████████                                                   ███                  ████████████                ██  ███              ███    ███     █████          ██████            ████████                                       ██       ██                      █          ███
██     ████████████                                       ██                             █████████████       ██          ███              ██     ██     ██████          ██████             ██  ███    ██                 ███             ██     █████                     ███        ███
██      ██████████████                                   ████                             ████████████      ████         ██                            ████████         ██████                  ███  ████               ████                  ████████                     ███       ███
██            ██████████                         █       █████                             ███████████      ████        ██                             ████████          █████                   ██  █████             ███                   ██████████                     ██        ██
██             ██████████                       ███       █████                             ██████          ████       ███      ██                      ██   █            ███                    ███  ████████         ██                    █████  ███                               ██
██              █████████                       ███         ████        █                   █████            ██        ███     ████                                                  ██           ██   ████████        ██                     ███    █           ██                  ███
██               ███████                        ███          ███       ███                  █████                      ███     ████                                  ███            ████          ███   ████████       ███                    ███               ███████             ████
███  ██     ██    ███     ██              ███   ████         ███       ███                 ██████                     █████   ████                                  ████           █████    ███  ████    ████████      ████     ███           ████             █████████           █████
█████████  ████         █████  ████      █████   ████       █████      ████               ███████                ██████████████████  ████                    ████████████        ████████  ███████████  ██████████    ███████  █████         ██████         █████████████         ██████
████████████████    ██████████████████  ███████   ████████████████    ████████    ████████████████       ████████████████████████████████████  ███████  ███████████████████   ███████████████████████████████████████████████████████████████████████████  █████████████████████████████
████████████████████████████████████████████████ ███████████████████████████████████████████████████████████████████████████████████████████████████████████████████████████████████████████████████████████████████████████████████████████████████████████████████████████████████████
