████████████████████████████████████████████████████████████████████████████████████████████████████████████████████████████████████████████████████████████████████████████████████████████████████████████████████████████████████████████████████████████████████████████████████████
█████████████████████████████████████     ███████████  ████████████████████████████████████████████████   ██████  █████████████████████████████████████████████████████████████████████████████████████████████████████████████████████     ████████████████████████████████████████████
███████████████████ ███████     ████        ██████      ███  ██████████████████      █████████████████     ████    █   ███████████████████████████   ███        ██████████████         ███████████████  ███████████       ███████████        █████    ███████    ███████    ██    ██████
██████████████████   █████       ███                    ██    ████████████████        ████████████████     ███           ███████    ████████   ██                ██    ██████           ████  ███████     ████████             ██████                  ████       █████            █████
██   ██              █████        ███                   ██     ██   █████████            █████   █████     ███    ██      █████          ██                            ██████           ███    █████       ███████             ██████████              ███       ██████           ██████
█                    ████          █                   ████          ████████            ████     ████     ███    █████    ███                           ██   ██     █████████          ███     ███         ███████             ███████████                  █████████           ███████
█                    ███                               ████           ██████           █████      ████             ████                                 ██████████  █████  ████          █     ████          █████████              █████████               ██████████           ███████
██                    ██                         ███    ██             █████          █████       ████              ███                                 ████████████████    ████            ████████             ██████     ███      █████████              ██████████            █  ███
██       █            ███                 █     █████                  █████          ████         ███                                                  ████████████████     ████          █████████              ████     ███████    ████████              ███████████               ██
██      ███           ████               ███   ██████                  █████          ███                                                █████          ████  ████  ████     █████        ██████████               ██      ████████    ██                    ██     ███                █
██      ███           ███████            █████████████          █     ██████    ██    ███                                               ███████          ██    ██    ██     ███████       ███  █████               ██       ███████                                                    █
███                 ██████████          ████████████████       ███   ██████     ██     ██                                              ████████                ██          █████████      ██    ████              ████      ██████                                                    ██
███                ██████████          █████      ████████     ██████████       ██     ███                                            ████████                ████         ██████████     ██     ██              ██████    ████                                                      ███
███               ██████████       ████████        ████████    █████████        ██      ██                   ███                      ████████               ██████         ██  █████      ██                    █████    ████                     █                 ██              ███
███               █████████      ██████████        █████████   ████████        ████     ██                   █████                     ████████               ██████             ████                             ██      ████                    ██        ████    ████     ███     ███
███               █████████     ████████████      ██████████   ████            █████   ████       ███        ███████                       ████      ██         ████             ████                                      ██                             ██████    ████    ████      ██
████       ███    █████████    █████████████      ██████████   ███             ████████████████  █████      ████████    ██       ██          █      ████         ███             █████                   ██                                              ██████     ████   ██████     ██
█████      ███    ██████████   █████████████       ████████     ██     ███     ███████████████████████      ███  ███   ████     ████               ██████         ██             ██████                 ████                                ███           ██       ████   ███████     ██
██████      ███  ███████████    ████  ██████        ███████     ██   ██████     █████████████████████       ██         █████    █████             ███████         ██            ████████                ████                 ██            █████████              █████   ███████     ██
██████      ████████████████    ███    ████         ████████   █████████████    ███████████████████                    █████     ████           ████████                   ██████████████                ██     ████        ████          ███████████            █████    ██████       █
██████      ████████████████                       █████████████████████████    ██████████████████      ██       █        ██     █████        █████                       ███████████████████                   █████       ████          ███████████           █████      ██          █
██████     ██████████████████                     ██████████████████████████    █████████████████      ████     ███               ████       █████                        █████  █████████████                  █████        ██            ███████████          █████                  █
██████    ███████████████████                   █████████       ████████████    ████████████████       ████     ████              █████     ████         ██              █████     ███████████                   ███                        ███████████          ████                 ██
██████    ████████████████████          ██     █████             ██████████      ██████████████        ████      ███████          ██████   ████         ██████          █████        ██████████                                    ██       ███    █████          ██                 ███
██████    ██ █████████████████         ███      ███              █████████       █████████             ███        ███████        ███████    ██     █    ███████         █████          ███████████      ██                        ████     ████     ████                             ███
██████        █████████████████         ██       ███             █████████        ███████              ███  ███    █████       █████████           ██    █████         ██████           ███████████    ███                        ████     ████      ███             ███              ██
███████      ███████████████████                  ████           ████████          ██████             ████ █████              ██████████           █      ███         ██████    █      ████████████     ██                         ██       ██                      █████             ██
███████     ████████        █████                 █████              ████           ████              ███  ██████            ███████                      ██          ███      ███     ███     ████                                                                ██████     ███     ██
██████      ████             ██████                ███                ███            ██              ████   █████          ████████                      ███                                    ███                 ██                                     ██      █████     █████    ██
█████      ████              ███████                                  ███                           █████      █          ██████                         ████                                   ███                ████   ██  ██                           ███      ██      ███████  ███
████      █████             █████████                                ███    █                      ██████               ███████               █           ████                                  ███                ██████████████                           ███             ████████████
████     ██████   ██        █    ████                              ████    ███                    ███████              ███████               ███           ████                                  ███  ███           █████████████                           █████            ███████████
███      █████   ████     ███     ██                              █████    ███      █            ████████             █████                  ███            ████    ███                           ████████          ████████████                            ██████            █████  ███
███              ███     ███                                     █████     ██       ██          ████████             █████                   ██              ███   ████          ██         ███   █████████        █████   ████     █████                   ███████            ███    ██
███              ██      ███                                     █████     ██       █           ████████            █████                                    ████ █████          ███   ████████   █████████       █████    ███     ██████               █    ██████            ███    ██
███              ██                       ██                      ████     ██                   ███████              ███      ███                           ██████████            █████████████   █████████      ██████   ███      ████                ███   █████    █████          ███
████            ███                       ███      ███    ██       ██                            █████                        ███                         ██████████              ████████████    ███  ████     ██████   ████      ███                 ███   ████    ██████          ███
████             █                        ██       ████  ████                                     ██                       ██████                  ██    ████  ████              ████████████      █    ███     ██████   ████      ██                   █    ██      ██████          ███
████                           ██                  ██████████                                              ██             ███████                  ██     █     ██               ████   ████            ███    ███████    ██                                ██        ██            ████
███                           █████                ██████████                              ███         ███████     ██     ███████                 ███                            ███     ██             ██    █████████                                     ██                      ████
███      ███                  ███████               █████████   ██                        ████        █████████  ██████  ████████               ██████                 ██       ████                   ███   ██████████                      █████         ████                     ████
███     █████                  ███████              ██████████████                        ████        ███████████████████████████              ███████                ████     █████              ███████   ████  █████                   ████████        ███████                   ████
███   ███████                   █████████           ██████████████         ███   ██        ██          ██████████████████████████             ███████                 █████   █████           ██████████   ████    ███                   █████████        ████████                 █████
████████████                     █████████          ███████████████  ███████████████                    ██   ██████████████  ████              ██████                  ███████████           ██████████    ███                           ████████         ███████    ██            █████
████████████                     █████████           ████████████████████████████████                   ██   █████████████    ███               ████                     ████████           ███████         ██                            ██████         █████      ████          ██████
███████████                       ████████              █████████████████████████████          ███      ███  ███████████       █                 ██                       ██████           ███████          ███                           █████        ██████      ██████        ███████
████  ████                        ███████                 ██████████       ██████████         █████     ███   ██  █████                                                    █████            █                ███                           ████       ███████      ███████      ████████
████                             ██████                    ████████         █████████         █████     ███        ███                               ██                     ████                             ████                          ████      ███████        ██████     █████████
████                             █████                                      ████████           ███                                                  ████          ████       ██                             ██████               ██         ████     ██████          ████     ██████████
████           ████              █████                                     ████████                                                                 ███          █████                                      ██████         █    ████        █████    ██████           ██      ██████████
████        ████████             ██████   ██                               ████                              ███████                                ███         ██████           ██                         █████         ███   █████       █████     █████                    █████████
████       █████████              ██████ ████                   ███       ████                               ████████                                █        ███████           ██████                ██     ██            ██████████       ████        ███                     ████████
█████      █████████              █████ █████      █   ██   ███████      █████                                ████████                                        █             ██████████               ████            █     ███████████      ███          █                ██     ███████
███████     ██  ███                ███   ███      ███  ███ ████████     ██████                 ██             █████████                                                    ███████████               ████          ████     ███████████                                  ████         ██
████████                                  ██           █████████████   ███████                 ███           ██████████                                                     █████████                ████        █████      ████████████                           ███████████         █
█████████                                 ██           ████████   ███████████                 ████        █████████████              ██   ██                                     ███                 ████       █████        ████████████           ██             ███████████        ██
██████████      ██                        ███         ███████      ███████       █████  ██    █████       ████████  ████            ████ ████      ███                                               ████  ██  █████            ███  ██████   ███                   ███████████     ████
███████████    ████          ███          ████       ███████           ██       ███████████   ██████       ██████    ███████         ██ █████     █████                                        ██    ██████████████                     ██████████                     ████████    █████
████████████   ████         █████         ████       ████                       ███████████   ██████        ████       ██████            ████     ██████                            ████      █████ █████████████                        █████████       ██             ███████    █████
█████████████   ███        ███████        ███       ████                         ██   ██████   █████                    █████    ███     ███      ██████    ███                    █████     ███████████████████                         █████████      ███                        █████
███████  ████              ████████       ███       ███                                █████     ███                    ██████  █████    ███      █████    ███████                █████    █████████████████████                         █████████      ███       █                █████
██████    ███               ████████       ██        █                                  ████      ███                   █████████████             ████    █████████               ███     █████████████████  ██                           █████          █       ███               █████
██████                █      ███████       ██                                            ██       ███    ███             ████████████             ████   ███████████  ██         ███      ███      ███████             ██                   ██                   ████               ████
██████                        ███████       █                  ███                                ██    █████               ██████████  ██       ████████████████████████        ███                ██████        ████████   ████                                 ███                ███
██████                        ███████████   ██                █████                               ██    ██████               ██████████████     █████████████████████████        ███           ███  ██████      ██████████████████    ██                          ███        ██       ██
███████        ██████    ███  █████████████████   ███     ██████████           ████              ████  ████████   ████       ███████████████  ████████████████████████████       ████         ████████████     ████████████████████  ████  ███    █████          ████       ████      ██
███████████   ████████  ██████████████████████████████████████████████████  █████████████    ██████████████████████████████ ████████████████████████████████████████████████    ███████████████████████████  ████████████████████████████████████████████████   ██████   ████████    ███
████████████████████████████████████████████████████████████████████████████████████████████████████████████████████████████████████████████████████████████████████████████████████████████████████████████████████████████████████████████████████████████████████████████████████████
