████████████████████████████████████████████████████████████████████████████████████████████████████████████████████████████████████████████████████████████████████████████████████████████████████████████████████████████████████████████████████████████████████████████████████████
█ █     ██ █████ █  █  █ █ █  ██  █ █  █      ███    ████  ████ ██  █ █     █ █   ███  █  ██    ███   ██     █ █ █ ███ ███      █    █     █████ █     ██ ███ █ █ █ ████ ██     █ ██     █ █  ██   █ ██      █  █   █  ██      █  █  ██  ██    ██  █ ██   ██  ██  ██   █    █    █   ███
██  ██   █ █     █    ██ █     █       █   █ █  ██  █ ███ ████ █      █ █  ████  █████ █   ███ ██  ███ █   █ █   █    █  ████   █  █   █ ██ ██  █ █ ██  █   █ ██  ██ █    █ ██ █  ███  ██      █        ████    ████ █ ██  ██ ██  █  █ █████          ██ █ █ ███ █  ██  █    █    █    █
████████ ██ ███ █ █ █      █    █ ███ █████      ██ ██ █████  █  ██   █ █  █   █ █ █ █  ██      ███ ██   █ █   █  █  ███ █  █  ████  ███      █  ███  ███ █ █  ███  ██ ██ █   ████ █ ██ █  █   █ █   █   █ ██  █ █   ██    ██ █ █      ██ ███ ██ █ ██ █    ██  ██ ███████             ██
███ █  █  ███ █     █  ███   █    █████   █ █ █  █   ████            █   █ ███           █ █████     █  █ █ ███ █ █ █     █   █████ █   ██ ██  █████  ██████      █  ███ ██   ██ ██   ██      ██ ██ ██ █ █ █ █ ██ ███   ██ █ ██████  ████  ███  ██      █    ████    █    █   █    █   █
█   ███ █   ██ ██ ██  █       ██   █ █ █ █      █ █   █     ██ █  ███  █      ██████ ███ ██ █ █ █ █  ██ █   █ ███ █ █████ █ █  █  █  ██   ██   █    █ █████  ██ █   ██  ██ ██ ████████ ███ █ ███   ████    ███ █   ██  █      █   ██   ███ █    ██   █████     ██    ██  █     ██    █ █
█ █   ██  ██ ██   ██  █   █  ██     ██ ██         █ █ █     ███ █ █  ███ ██  ███     █  █  █    ████ ██ █    █ ████ ██   ██    █      █ ███ ███ ██  █████  █ ███   █ █    █ █  █  █     █████      ██    ████████  █   ████ ██      ██   ███   █ █ █  █ █       █████    ██   █ █    ███
█   █  █████   ██  ██      ███ █ ██████ ███     ██  █  ███   ███     ██   ██ █  █ █  █       ██ ███ █ █   █  █ █  █ █ █  ███  █    █████ █ ███          ██  █  █ █ ███ ██  █   ███  █ █ ██ ██ ██        █   ██   ██ ████ █  █    █ █  ██ █    █ █████ █████  █ █ █████  █ ██    █ █ █  █
███   ███  ███    █  █   █ █       █ ██ █████ █ █    ██  ██ █ █      ██ █████  █ █    █ ███ ██   █ █ █ ██ ███ ███     ██  ████ █   █ █ █ █  █  ███  █ █ ██ █████   █ ████   █  █ ██ ██    ██   ███  ██   █    ██   █ █ █     ██  ██   ██ █  █ █ ██   ███ ███ ██  ████     ██ █  █ █   ██
██ █ █   ███  █   █ █   ██     █ █ █ █ █     █   █   █ ██  ██ █ ███   ██  █ ████   █ ██  ██  █ ██ █   █ █    █████ ██ █ █  ███     ██         ████████ ██  █    ██  █ █ ███ █   █    ██  █ ███    █ ██  ████  ████  █ ██  █ █   █ ██ █ █   █  █   ████ █    █    ██ ██ ██  ██     █    █
███  ███  █  ██ ███ █ █   ██  ████    ███ █ █  ███    █  █    █ █  █  ██████ ████ ██  █  ████   ██  █  █ ████  █  ███  █    █ ██ ██ █       ██       ██  █  █ █ █ █  ██    ██   █ █ █  ████ █  █  ██   █ █ █ █ ███    █ ██   █ █ █   █ ██  █ █ █ ███ █ ███ █  █  ███          █ █    █ █
██ ██  █ █ █     █ ██ ███ ██     ███   ███     █ █ ███           ██ ██   █   ██████ █     █  █ █ █ █  █ █████ █  █ █   ████ █ ██████  █  ██ ██     █ █   █  █ ███ █   █████ ██  ██    ██  █  █   █   █ ██   █ ██ █ █      █ ███ ██████  █  █ ███  ███ ████ ███ ███      ██████    █  █ █
█  ███ █       ██  ██ █   █ ███     █      ███ █ █ █  ██   ██      █     ██  █ ███  ██ ██ ███ ████  █ ████  ██  ██       █ █    ███  █     ██ ██ █ ██ ██ ███  ██ █ █ ████   ███    ████ ██ █ █████  █████      █  ████ ███████     ███ ███   ███  ███    █ █ █ █  █   █ █    ███ ██   ██
█  █ ██ █ █   █ ██ ██   █ ████ █ ███ ██ ██ ██ ██ █ █  █ █████ █ █   █   █ ███  ████ ██  █    █   ██  █ █   █ █ ██  █  ████ ███ ██ ███ █ ██  ██   █ ██  ██     █ █ ██ ██   █ █  ██  ██   █████    ██   █████ █  █ █  █ █ █ ██  ████ ██      ██     █   █  ███ ██   █  ██ ███  █ ██  █  ██
████  █  ████ █ ██  █ ██    ██  █  █   █    █ ██   █  ███  ██    █ █  ██ █    █ █ █ █  ██  █  █     ██  ██ ██  █  █  █ █ ███ ███  ███   █ █ █  █  █    ██   █  █    ██ ██ ██   █████   █  █ ███ █  █ █  █ ██ █  █ █ █  █ █  █ █   █ █ █ ██ █  █  █    █  █   █  ██████ ████ █ █ ██    ██
██ █       ██ ████  █ ██ █ █   ██    ███  █  █   ███   ███ █  ██ ███  █ █     ███ ██ ███ ██     █ ██   ████ █ ██ ██     ███  █   █ ████     ██ ██    █  ██      ██     ████    ██  ██ █  █   █ █    ██   ██  █ ██ █   ███  ██  ███   █     █  ██  █  █   █  █   █     █ █  █   █ █   ███
████ █     █ ██  ███ █       █     █ ███ ██ █   █ █████  █  ██ █ ███ █ ██  █ ███  ██████  █  ██  █    ██ █   █ █  █      █  █ █  ███ █  █       █  █  ██ ██ ████ ███  █ █  ███     ██    ████ █ █   █    ██ █   █   █  █ █  █ █     ██████ █ ██ ██ ████  █ █  ██ █ ██   █ █ ██ ████  █ █
█ ███ ██  ██  █   █ ██ ████  █ █ █  ████ ██ ██ ██  ██   █  █    ██ ████   █    ██     ██  ██  █   ██   █ ██ █ █ ██ ██  ██     █ ██ ███   ████ ████ █     █  █   █    ██    ██     ██    ███  █  ██ ██ █ ██  ███   █ █ █ ██ █ ██ ██  █████ █ ███    ███  █ ███ █ █  ███   █ █   █  ██ ███
██  ███  █ █  █  ███ █ █   █  █    █    ██   █ █  ██ ████  █ ██  █    ██  █  █   █ ██ ██ ███  ██ ██ ███ █ █ █   █   █   ████ █  █     ███ █ █  █ ██ ███ █ █   █   ██ ██ █ ███    █ ████  █ ████ ██  █ ████ ███ ██   █  ██  █████  ███ █  ████     █   █ ██ ██ █ █  █  █   ████ ██  █   █
█ █ █ ███     █   █  █ █   █  ██    █ ██ ██   ██ ██  █ █   █   █████      ██ █  ███  ███ ██     █ ███     █  █ █ █ █ ██ █  ███ ███ █   ██████  ██    ██    █      █  ██  ██     █ █   █ █ █ █ ████████  █     █  █     █  ███  ██ ██  █   █  ██ ███   █     ██ █      █  █     ███ █   █
███   ██  █     █  █  █ ████ █ █ █████    █ █     ███ ██ ███ ██   █   █  █ ████     █   █   █ █   █ █  ██ ██ ██ ██ █ █ █   █ █ ██ ██ █ ██    ██    █   ██ █ ███   █ ██   █ ██    ██ █    █    █    █ █  ████ ██ █        ██   █  █  ███  ██ █  █ ████ ███ █ ██   █    ██  ████████████ █
█ ██ ██ █  █  ██      ███  ███████ █ ███   █  █████████  █ █  █ ██   ██   █ █  ██ █   █   █  █   █ █  ██ ██  █  ████  ██ █ ██    █ █████          ██ ███  ██ ██     █   █████  █ ██████  ██   ███    ██ ██ █    █  █ █ ██ █       █  █  █  █  ████ ██         ██  █ █ ██  ███  █  █  ███
█ ██ ███ █     █ █    ██  █  ██   █    ██    █        █ █   █   █  ████ █   ██  ██ █  █   █ █   ████  ██ ███  █ ████ ███ █   ███     ███  █ ███  █ ██ ██ █  █  ███    ██  ██ █ ██ ██  ██  █ █  ██   ████  █  ███ ██ █         ██ █ ██   █ █   ██ █ █ █ █ █  ██  █    █      █   █ ███ ██
███ █ ███  ██ █ █     █ █ ██  █   █   ███ █  █   █ ██  █     ████ █  █           █ ██     █    █  ██      █  ████ ███        ██  ███ █████  █ █  █  █  █ ██  ███       ██  ██   █  ██     █ ███  █      ██  █ ██ █ █     █ █   ███ █ █     █ █ ██ █  █  ██ ██   █  █    ████  █ ███    █
██ ██ ███ █ █ █ █  ████ █ █ ██ █  █  ██   ██ ███    ██    █ █████ ██  █     █   ██ ██ █ ███ ██ ██    ██ █  █ ██ █     ██ ██ █ ██        ██ █ ███ █    █ █  █ █  █   █      ██ ████ █   █ ███ █ █ █   █ █  ███ █ ███   ███  ██ ██  █      ██  █  ███ ██    ██ █ ██ ██  █ █       █ █ █ ██
█   █ ███████    ██ █  █ ██ █  ███   ██ █  ██  ██   ██ █  ███   █   ██  ██  █ ██  ██ ██  ██  █ ██  █  ██ █ █ ███ █  █     █ █       █ ██   ██  █ █  ██████ █  █   █ █  ████ █ █ █   █ ██   ██ █    ████      █ ██ █ ██ █ ██  ███ █ ██  █  █   ███  ██ █    ██      ███ ███     ██ ██   █
██  ███  █  █ █     █   █  █  █ █ █ █ ██  ██ ██ ███ █ █    ███   ████  █  ██   █ █    █    █████    █     █ ██ █ █  █ ██ █ █    █    █ █████   ███ █ ███   █   █ ███ █ █ █   ██   ██   █ █      ██  ████       █     █ █    █ ██ ███  ██ █    █   █ █  █    ██ ███ ██ █  ██   ███  █   █
█ █  ███ █ █ █ █  █  ███ █ █ █   ████ █ ██  █  █████  ██  ███  █ █ █  ███  █ ██ ███ █ ██   ██   █ █ █ ███ ██      █ █  █    █  █ █ █  █ ███ ████    ██  █       █████ █ ██ █  ████   █ ██   ██ █   █    █ ██ ██  █   █  █ █  ██  █ ██ █     █ ██ ██ ███    █ █ █  █ █ ███ ████ ███  █  █
███ █ █  ██   ███  █   █████ █   █ ███   ███   ██ █    ██████   █   █                ███     █ █  ███  ████  █      ██    ██   █  ██ ██ ██         █ █ ███ ██  ██  █ ██  █   █  ███ ██ ██   ████ █ █ █     █ ██ ██ █ █  █ ██  █  █        █ █  █    █ ████    ███   █ ███  █ █  ████ █ █
███  █ █ ██     █ ███  ████ █████  █  ████  █ ███ ██     █  ███    ██  ██  █     █ ████  ██████ █  █ █    █ █ ██  ██ █████  █ ██ ██           █ ████  █ ███  ██ ██ ████ ██  █ ██  █ ██ ███ █ ██   █  █ ██ ██  █ █ █   █  █  ██ █ █ █ █ █   █ ██    ██    █     █ █ █ █ ██ ██    █  █  ██
██ ██     █    ██ ██ ██ █ █ █    █     █ ██ ███   ███ ██   █  ██  █ █    █  █ ██  █   ██    █ █  ██ █ █ █    █  █    █    ███   ██████      █       █   █     █   █     ████ ██    █  ███ █ █  ████  ████ ███   █       ███  █ █     ███ █   █      █ █   ██  █ █████ ██ █ ███  ██     █
██ █   █ █  ████  █ █    ██     █ ███ ███   █ ███  ██ ███ █     ██  █ ███  █ █   ███    █ ███ █ ███    ███ █  █ ██ █  ███  ██  █  █  ████    ██ █  █    █     ████  █ █     ██ █   █ █    ██     ██ █   █  █   █ █ █  ████ █ ██ ███ █  ██ █   ███ ███ ███ █    ██   ██ █      █ ████   █
█ ██ █       █ █ ████ █ █ █ ███ █   █ █ ██ █ █ █ █    █ ██ █ ██     ███    █ ██  ██ █    █   ███ ██  ████ █  █     ██   █ █   █    ███    ████  █     █  █ █ ███ █     █         ██ █ ██ ███████  █  █   █   █ █  █    █ ██  █  █  ███   ███ ██   █  ██ ██   █ ███   █    █   █ █  ███ █
█   █████ ████ ██    ██   █████  █  █  █  █ ███ ██    ███ █  █ ██ ██ ██ █ ███ ██ ████      ███████  █  ██ █  █  █  █  █ ██ █ █    █ ██ ██    ██  █ ██  ██    ██ █ ██   ██  █  █ ██ ██ ██ █     █ █ ██  █  ██ ███ █   █  ████ █    ████    █  █ █ ██  ██      ██  ███   █  █ █   █████ ██
█   █   ███    █ ██ ████ ██   █ █  ███   █   █   █ █ ████ █ █████ █ ███ █    █  ██   █    ████   █ ██   █ █  ███ ██  █   ██  █ █     ██ ██  ██ ███   █  ███ ██  ██ █ █ ██    ████ ███ ███   █      █   █    █    ███ ██    ███ █ █████ █ ████ ████████ ████     ███         █    █  █  █
██ █  █ █ ███      ███   █ █ ███ █   ████   █  ██   █ ██  █  █ ██   ████ ██  █ ██    █ ███  ██ █ ████   ██ █ █ █ █ █ █   █████ █   █     █     █     █ ███     █  ███  ██████ █ █ ███  █ ██    ████ ██   █   █  █ █     █  █     █    ██ █   ██ ██ █     █ █    █  ███    █ ██  ██ ███ █
█      ██  ██  ██ █ ██     ██  █   █ ██   ██      █    █ █ ██ █ █  █ ██  ██   █ ██  ██   ████     ██       ████  █████  ██      █ █  █   ██     █     ██ ██   █ ██ ███  █   █ ██ ██       ███ █████  █ █      █  █  █ █  ███  █   █  ██ █   █   ██████   ███ █   ██ █  █████  █ █  █   █
█ █  ██ ██    ██  ███   █   ██ ████ █ ███   ████    █   ██ █ █    ██ █ █ █ █  ███ ██    █  █      ███ ███    █ ██     █      █ ██ ██ ██     █ █  █ █ ████ ██        ███  █  █   █ ██ █  ██  █ █  ███ █  █       █         █    ██ ██      ████   █     ██  ███   █ ██     █ █ █  ███ ███
█  █ ███     ███ ██  █  ██ ████████  ██ █      █████  ██ █████    █  █ ███ █  ██ █  █ █   ██   ███  █ ██  ███ ███ ███ ██ ██   ██  █      █████ █ █  █ █ █         ██  ██ ██ ██   ██  █ ███ ████ ███           █    █  █  █     ███ █ █        █    ████ █   █ █  █  ██   █    ██       █
█          █   █   █ ██ ████ ████ █ █  █ ██ █ ███  █████  █ ██ ████ █  █ █  ███     ████ ████ █  ██ ██ ██ █ █ ██    █  ███ █  ██ ████ ██ █       █  ██   █   █████           █   █    ██ ████  ████  █ █   █   ██ █ ██  █ ██ █████  ███  ██ █ █   █ ██    ██ ██    █ ██        █████   █
██    █ ██  █  ██  █ █████       █ █   █████    █████   █████   ██  ██  █  ███  █   ███ █ █   ████  █ ██    ██   █    █  █████  █   ██ █ ██  █ █   █  █ █ █ ███ ██ ████ █  ███  █     ██ █     █ ███   █ █ █ ██ ██   █ ████ ██ █ ███ █  ██    █ █ ██  █  █ █ █  ██  █  ████ ███ █ █  ███
██  █ ██   █         █       █ █   ██   █  █    █ █    █ ██  █   ████     █   █   █ █   █  ███  ███           █ █     ███ █  ██   ███   ████ ██ ██ █ ████   ██  █ █    █     ██  █  █ ████ █ ██ █  █ █     █ █ ██ █   █  █ ███████   ██   ██   ██  █  ██ ██  █ █   ███ ██ █    ███ █ ███
██ ██ █ █ ███   █ ███   █   ███ █ ███████ █     █ ██ ███ █  █ █   █ █ ████  ███ █ █  ██ █    █  █  ██ █   █  █  ███ ███  █  ██    █  █    ████ █  █  ██   █ █ ██ █  █   ███ ██    █████   █ █  █   █  █  █ ██ ███  █ ██ █         █ ██   ██   █  █        ██  █████ █  █   █   █   █  ██
█     █  ██ ██         ███     █ ████ █ ██ ████ ███     █ █  ████ █  █  █        ██ █ █ █     ███  █   █   █   █   █  █ █     ██   ██  ████ ████   ██   █ ██    █ █   █████ █   ████ █ █ █  █  █  █  ████     █   █ █ █     █   █  █ █ █ ███   █  █  █ █  ███  █ █ ██████████   ███  █ █
██ █  █    █   ██ ██ █ ███ █ ███   █   ██ █    █ ██    █ █ ██   █   ██  █ ██    ████████  █ █  █ █  █  █    ██    █  █ █ █████       ██  ██ █  █  ██ ██    ███  █ █  ██  ████ █ ██ ██     █ █    █  ██  ██  █ ██ ███ █████   ███ █ ██ ██  █ █  █        █   █ █ █         ████     ██ ██
█   ██████     █ ██ █ █ ████ ███  ███    ████   ████  █   █ ██  ███ █ █  ███ █ █ █ █  ██ █       ██      █   █  █   █ █ █ █  ██  ██    █ ██    ██  ██       ██ ██   ███ ██    ██ █       ████   █       ██ ███████  █  ██  ███      █ ██  █ █    ███ █   █ █  █ █   ████ █ █     █    ██
██  ██ ██ █ ██  █ █    ██ ██ █ █       ██  █████ █ █  █ ███  ███ ██  ██ █ █ █       █ ██    █ ███   ██ ███ █  █  █  █   █     ██ █   █  █ █ █  ██ ███     █    ██ █  █ ███ █████ █ █ ██████ ██   █ ███ █ █ ██  ██ █ ██    ████ █ █      ██  ███  █   █ █ █  ██   █ █ ██ ███     █ █    █
████  █  █   ██ ██   █ ████ █  █     █ ███ █  ███   ██   █ ███ █  █    █   ██ █ █ █ █ █ █ █  █  █ █ █ █ █ ██   ███    █ ██  █  █ ██████  ████   █ █   ███      █  ███ █   ████  ██████  █ ███   █  ████  █  ██ █ ███ ██ █   ███ ██ ██      █ ██ ██  █ ██ █  ████  █ ███ █ █ ████████  ██
███████ █ █         ██  ███ █  ██  ██ █ ██  █ █  ██  █    █  ██   █ █     █ █   ███ █ ██   █ █   █      █  ██     █ █  █ █ █ ███ █ █   ██  ████   ███  █     ███    ███  █  █  █ █  ██       ███   █     █  █   ███ █  █     ██       █    ██  ████  ██ █ █    ███  █    ███ ██    ███ █
█  ██  ██   █       █      █      ███ █     ██ █ ███ █ ██  ███ █  █ ██ ██  ████  █          █ █  █   ██   █████  █   █ █ ███ ██   █    █ ████ ██    ██   ██    ███  █ ██  █  ██    █ █████   ██  █ █  █ █ ██     █ ██████   █   █  █ ██ █████    ██ █ █   ███ █ ██ █████    █        █ █
██ ██ █     █  █  █ █ ███ ██     █  █  █    ██  ███ ███  ██    █ █████████   █████ █       █ █ █ █   █   █ █ █  █   ██ █ █    █ ██ ██   █    █ ██████    ██ █ ███  █   ████  █ █   █  █ █    ███ █ ███ █ ██ ██ █    █      ██    █   █    ███  █ █ █  ██████     █  █ █    █ ██ █ █ █  █
█ █    █  ███  ███  ███ █    █ █ ██ ███ █ █ █  ███    █ ████ ███  █ █     ██ ██ ████ ███ █  █    ███ ██   █ ██ █ █ █     █  █    █ ██  ██      █    ███  █   █ ██ ██       ██  █ █   ██ █    █  █ ████████    █ ████   █  █ █ ██ █   █    █ █  ███  █ █       ███ █ █ █ █  ██ █     █ ██
██ █     ██████ █  █  ██ █████  █ ████     █     ███  █     █    ██    ██ █      ██ ███ ███ ██    ██   ██ █ ██ ████ ██  ███  ██ ██ █  █   ██  █  █   █   █   ███   █ █ ███████ ██ █     ██ ██  █   ██ █   ██  ██ ███  ███  █    █ █ ██    █  █   ███ ██ █  █████  █ ██ █   █ █   ██  █ █
███ ██ ████    ██ ███ █████ █  ██     ███ ████ █ █ █  ██ ██ █  ██      ████ █ █ ██ ██ ████  █   █ ███ █  █ ██  █   ██ █      █  █   ███  █ ██ █ █  █ ██      ██ █    █   ██   █   ███  █  ██ ███  ███ █  █  █ ███████   █    █ █  ████████ █     ██  ███   █  ███ █  ██ ████  █  ██ █ ██
███ █ █     █   ██ █  █  █  █ █  ██ ██  ██ █ ██  █    ██   ██ ██   █      ███ █ ██   █ ██ █   ██        █  ██  █   █  █     █ █   █████    ██ █     ██    ████  █ ██  █ ██ █  ███ ██████ █ ██ ██   ███  ████  ██ ████ ██    █   █ █ ██████ █    █ █  ███  █ ██ █████   █  █ ██      █ ██
█  █  █ █ █ █ ██ ██    █   █  █ █  ███    ██ █     █  ██ █████ █   █ ██   █  █  █  █    █  █ █  █ █  █ █ ██ █  █ █  ██   █ █ █ █ █  █ █ ███ █   █ █    ██     ██     █ █ █ ██  █ ███ █   ████████    █   █        ████  ██     ███  ██  ████       █ █ █   ███   █     ██ ███     █   ██
██   █████ █ █ █   █  █  █ █   ████ █ ████         █     █      ██     ████   ██ █    █████ ██  ████ ██    █ █ ███████    █  █      ████████  █ █  █ ██ █  ██ █ ███ █   ██    ███  █ █ █ █  ██   █     ██   ███████  █ █ █  █ ███████    █         █     █    ███  █ █  ███  █ ███  █ ██
█   █  █ █  ████ █          ███     ██  █ █     █   █  █ █ █ ████ █  ██   ██ █     ███ █    █ ██   █   ██████  █    █   ██ ██ █   █  ███ ██   ██  ██ █ █ █  █  █  ███ █ ██ ██ █  █   █   ██    █ ███   █ █ █ █ ███  █  ██      █  █  ██     █   ██ █      ████  █        █ █   █    █ ██
███     █   ████ ██   █    █ █ █ █ ██  █████ ██    ██ ██████    █ ██  ██ ████ █  █ ██ █   ████         ██  ██ █  █ █   █ █   █ ████████  ███ █   ███ █  ███     █  █  █ █     ██  ████     ██  █ █ ██   ██    █ █      █    ████ ██ █  █  █  ███          ███ █ █    █ █       ███   ███
█ █████   █ ██ ██   █ █  ██ ███   █ ██   ██ ██ █     ██  █ █ █ █ █ ████  █ ██ ██ ██    ██           ██  ███  █  █ █   ██ █         █  ███    █ █ ██ █ ███ █ ██   █ █  █  ████  █ ████    █   █  ██  █ ███  █      ██ ███   ██████     █  █ █  ██  ██ █     █████    ███  █ ██ ███   ██ █
████ ██        █   █  ██ ██      █  █ █  ██ ███  █████ ███ ██ █  █   ██ ████    █      █ █ █  ██   █ █ ███  █   █ ███████  █  █ █ █ █ █ ██ ██ ██ █ ███  ██     ███████ █  ██ █    █   ██ █  █ ██     █  ██ █ ██ ███  ██ █ █   █ █  █ █  ██ █   ████ ██    ██ ████ ██    █ █  █    ███  █
█  ██  ██  ██ █ ████ █ ██ █  █ █  █  █ █ █ ██  █ █    ███  ██      ██ ███  ██ █ █  █ █████ ██ ███ ██    █ ███   █ █ █    █   ██      ███ █ █ █   ██ █  █   ████    ████     ██ █ ███  █   ██ █  █  █ █ ███    ███ █  ██  █ ██  █ █ █  ██  █ █  █████  █████ █     █ ██  █ █ ███   █    █
█ ███  ██    ██ █       █ █ █ ██ █ █  ██ █████  █  █  ██   ███████   █  █      █   █████ ██████   █ ██ ██ ██        ██ █  █ █ ██  ██  ██ █  █  █   ██  █  ████  ████  █    ██     ████   █ ██  ██ ██████  ██ █ █        ██ █  █ ███ ████   ███  █  █  █   █   ██        ███ ██  █ █ ██ █
██   ███ █ ██  ██ █ ███ █     █ ███ █  █   ██   █ █ █    ████  ██    ██  █  █ ███ ███  █ ██ ██  ███ ██  █   █  ██  █  █  █ █   ██    █       ████        ███    █ ███ █ █ █ █ █  █   ██      █    ██   ███ █  █ ██ ██ ██████  ██████ ███     ██    █ █    █ █   █      ██  ██ █ ███ █ ██
██    ██  █ █  █ █ █████   █ █        ███    █ █  █████    █  █ █  █     ███ ███  █   █     █ ████   █    █   █ ███ █ █  █ █   █    ██ █  █ █  ████████ █ ██ █  █ █      █  █     ██ █  █ █  █     █  █      █   ███ ███  █ █    █ █ ████    █  ██ █████ █ ███  ███   ████████    █ ████
█  █ ██   █ ██ ████ ███     █  █      █████  ██ █  ██   █ ██  ████  ██ ██ ███    █ █    █ █  █   ███ █  █████  █ █ █ ███████     █ █ █ █     ██ ██  █  █ ██  ██ █ █ █        █ ██ █████ ██ █ ██      █ █   █ ██ █  ███   █    █ ███ ████  ██ █ ███████  ██  ██ ██  ██ █ █  ███ █     █ █
█  ███ █  █ █ ██   ██     █ █████ ████       ██    ██ █ █   ██ █ ████ █  ██  █ █     ██    █  █  █ ██  ███ █  ██  █ █   ██ ██ █ █ █ ██   ██   ██ █ ██  █ █  █ █ █  █ ██      █ █ ██  ███ █    ███    █ █ █ █ ██  ██████ █   ███ █ ███     ██ ███ ██     ███   █  █ ██ █  ████ ███ ███  █
████████████████████████████████████████████████████████████████████████████████████████████████████████████████████████████████████████████████████████████████████████████████████████████████████████████████████████████████████████████████████████████████████████████████████████
