██████████████████████████████████████████████████████████████████████████████████████████████████████████████████████████████████████████████████████
██████████████████████████████████████████████████   █████████████████  ████████████████████  █████████████████████████████    ███████████████████████
██████   ████        ███████ █████████████████        ████       █████  ████  ███  ██ █████    ██  ██████████████████████             █████        ███
█████     ██          ██████ ████████████████          ██         ██████████           ███     ██      ████     ██  ████               ████         ██
██████    ██    █     ███████████████████████         ███         ██████████           ███    ██                                       ████         ██
███████        █████  ███████████████████████       █████          ██████████          ███     █                                 █    █████         ██
████████        ████  ████████████  █████████       █████            ████ ███         ████                                       ██████████         ██
██  ████          ██   ███  ███      ████████        ███                   ███      ██████        ███                            ██████████         ██
█    ███                    █        ████████         ██                    ██     ████████      █████                ███         ██████████      ████
█    ███      ███          ██       █████              █                    ██    █████████     ███████         █    █████        ███████████    █████
██    █      █████        ███      ███                              ██      ██    ████████       ███████       ███    ███         ███████ ███    █████
██        ████████     █████       ██                              ████           ████           ███████      ████               ███████   ██     ████
██        ████████    ████                                         ████            ██             ███      ██████          ██   ████████   ██       ██
██        ████████   ████                               ██          ██                            ███      ███            ██████████████   ██        █
██     █   ██████    ███                 ██            ███                                        ███      ███            ██████  ██████   ███       █
██         █████           █             ██           ███                     ███                 ███      ███            █████     ████   ██████    █
██         ███            ███        ███             ███         ██          █████                 ██       █    █         ████      ███   ███████  ██
██         ██      █      ███       ███            █████        ████         █████████                          ███         ███████ ████    ██████  ██
██        ███      ███              ███     ████████████        █████         ████████████                     ████         ████████████     █████  ██
██      █████      ████              █      █████████████        ████          ████████████     █              ███          ████████████       ██  ███
███    ██████       ███                      ███████████           ██          ████████████    ███     ██      ███          ███████████            ███
███     ████        ███                       █████████             ██     █   ██████  ████   ███      ██      ███          ██████████   ██         ██
████     ██        ████                       █████████                   ███  ████     ██    ███               ███         ████                    ██
████     ██       ████                        ██████████                  ██  ████     ██      ██               ████████     █                      ██
█████   ████      ███             █            ██████████                     ████             ███           ████████████                  ██       ██
█████   █████     ██              ██                                          █████            ███          ██████ ██████          ██    ████       ██
█████    █████                             ██                                ███████                       ████     ████          ██████████         █
█████    █████                      █████ ████                               ████████         ██     █    ████      ██             ████████          █
██████   ███ █                       █████████                ██       █    ██████████              ██    ███       █                █              ██
███████ ███                          █████  ██   ███        █████      ██   ████   █████                  ███                      █             █████
███████████                          ████        ███       █████            ███     █████                  ███           ██      ███     ███     █████
███████████                          ███                   ██               ███      ████                   ███ ███     ████    ████████████     █████
██████  ██████                       ██                    █                ██        ████ ████ █           ████████     ████    ██████████     ██████
█████      ████                      ██               ██                              ███████████            ██████      ████       ███████   ████████
██████      ███                       █              ████          █████              ██████████             █████       ███         █████   █████████
████████    ███            █                          ██     ███  ███████             █████████               ███                    ████   ██████████
██████████  ████           █                                ████  ███████             █████████                                            ███████████
████████████████                                           ██████     ████           █████████                                            ████ ███████
██████████████████                                        ███████      ███           █████████                               █           █████  ██████
█████    ██████████          ██                           ██████       ████           ████████     ██          █            ███         █████   ██████
████       ████████    █     █                            █████         █████          ████████   ████         █             ███       ██████   ██████
████        ████████ ████                            █    ████         ███████          ██  ███████████                      ████     ███       ██████
█████      ███   █████████            █████  ██████████   ███       █   ██████               ███████████                     ████    ██         ██████
████      ███     ███████            █████████████████    ██       ███  ██████                █████  ██████                   ██               ███████
███      ████     ████              ███████████████               ████   █████                 ███    ██████    █                              ███████
██       ███      ███              ██████████                     ████    █████                ███    ███████  ███                        ███ ████████
██        █       ██               █████████                     ██████    █████         ██    ██     ████████████     ██                 ████████████
██               ███    ██         ████████                      ██████    █████         ███  ███     ███████████     ███                 ████████████
██            ██████    ███        ███████                       █████     ██████       ████   █       █████████       █          █          █████████
██          ███████      ███       █████                          ██        ███████      ██              ███████                ████               ███
██         ███████        ███     █████                                       ██████                      ██████             ██████                 ██
██        █████            ███   ██████                                        █████              ███    ███████            ██████   █ █            ██
██         ███              ██   █████                                          ████              ███   █████████    █   ████████   ████            ██
██        ████    ████       ██  ████                  ██                       ████      ███     ██   █████████    ███████  ███    ██      ████    ██
██       █████   ████  █     ███████         ██        █                       █████     █████         █████        █████     █             █████   ██
██   █████████  ████   ██    ██████         ████████                           █████      ███           ███        █████                    █████  ███
██  █████████    █      ██  ██████           ███████                           ██████          █        ███       █████                            ███
█    █████              █████████               ███                  ███         ████         ███       ███    ██ ████                             ███
█     ████             █████████                                   █████████      ██   █      ███       ███    █  ███                              ███
██     ███          ████████             ██           ███         ████████            ███     ███       ██                         ██              ███
██     ███         █████████            ███           ██████  ███████████             ████     █████              ██              ███               ██
██      ██        █████████             ████           ██████████████                ██████    █████             ███   ██          █                ██
███      █       ████                   ███               ██████████                ███████    ████               █    ██                           ██
███             ████                     █                 █████████                 █████    ███                     ███                           ██
███            █████            █                           ████████                 █████   ███                      ███   █                       ██
███           ███████           ██                 ███      █████████                 ████  ███       ██              ██    ██            ███       ██
███           ███████           ███               █████     █████████                  ███   █       ████                                 ████      ██
████           ██████           ███               ██████    ██   ████            ██    ███          █████                                  ███      ██
████          ████████    ██    ████     ████     █████    ███                  ████  ████    ████  ██████                                 ██       ██
███        ███████████    ██   █████    █████     ███     ████                 █████  ███     ████   █████                ███             ███       ██
██        ████████████    ██   ██████  █████     ████     ███                  █████  ███      ███    ███                  ███████       ████       ██
█         ███  ███████          █ ███   ██     █████      ███                 █████    █                    ██    ███         ████      ████        ██
█         ██    ██████             ██         █████       ████                 ██                           ███   ████                 ███           █
█         ██    █████   ██          ██        ████        █████                                             ██    ████    ██          ██             █
██        █      ████  ████         ██        ███         ███████                      ███                         ██     ███                        █
██               ██████████        ███        ██          █████████                   ███████                             ██████                     █
██              ████████████       █████     ███          ██████████                  ███████     ████                     ███████     ███    ██    ██
██    █         ████  ███████████   ██████   ███           ████████             ███  ████████     █████                     ███████    ████   ███   ██
██   ███        ██     ███████████     ██     █            ███                  ███████████       ██████                     █████     ████    ██  ███
██    ███               █████   ███                        ██           ██       ██████████       █████     ██               ███       ███        ████
███    █                ████     ███                      ███         █████       █████████        █████   ████              ██       ████        ████
████                    ████     ████                      █   █      ██████      █████████         ████████████                      ███          ███
██████  ██  ███          ██      ████                        ███       ██████     ████████             ████  ████       ██           ███           ███
███████████████    ██            ███                          ██          ██      ████████     ██       ███   ███       ███           █            ███
███████████████   ████            █       █                   ██                 █████████    ███        ███  ███       ███    █████               ███
███████████████   ████                                                          ██████████   ████         █    ███       ██  █████                ████
█████████   ████  ████          ██               ████    ███                   █████████████████                ██        ████████               █████
████████     ███   ██   ██      ██              ████████████                ███████████████████       ██       ███        ████████              ██████
██   ██       █        ███     ████              ███████████               ██████  ███████████     █████      █████       ███████    ██        ███████
█                    █████    █████   █              ███████     ██       ██████    █████████     ██████      █████       ████       █████     ███████
██    ██            ██████   ██████   █                   ███   ████       ████     ███████        ████         ███                  ███████   ███████
███   ███           █████    ███           ████            █████████                 ████                                            ███████   ███████
████  ███           █████    █             █████              ██████                                                         ███     ███████    ███ ██
█████  ███          █████                   ███                  ██                        █████                             ███      ████       █████
█████  ███          ████                    ████       ████                               ███████           ████             ███                 █████
█████   ███         ████                   ██████      █████            ██████           ████████          ██████       ███ ████                  ████
█████   ███       ███████                  ███████     █████           █████████        █████████          ███████     ████████                   ████
████████████    ████████                   ██████        ██           ███████████      ██████████           ██████     ███████                    ████
█████████████  ████                         ████                       ██████████     ████████████          █ ████     ██████                     ████
███      █████████             ████          ██     ███                    ████   █  ██████  █████              ███   ██████         ██          █████
██        ███████             ██████                ██                      ███     ██████    ████        █          ████████       ████         █████
██       ███████              ██████      ██                                ███      ██        ██       ███         ████████         ███         █████
██      ███████               ██████      ██                  █             ███      █                 █████        ███████          ███        ██████
█      ████████          █     ██████     ██                  █             ██        █                ████          ████             ██        ██████
█      █████████       ████      █████                                               ███               ████    ██     ██                        ██████
██    ██████████████████████       ███                           ████                ████               ██    ███     ██                         █████
██    ███████████████████████       ████             ███        ██████               ███                      ███     ███       █         ██      ████
██        ███████████████████        ███     ██████ ████           █████             ██    ████  ███         ███     ████      ██         ███      ███
██      █████████████  █████           █████████████████             ████            ███ ██████  ████       ███     ████      ████         ███     ███
██       ███████████    ███             ███████████████              ████     ██      █████████████████            █████     █████          ██      ██
███     ███████ █████                    █████████████            ██   ███  █████     █████████   █████             █████   ███████         ██      ██
████     ██      ████                       █████████            ███    ██████████          ███      ██              ████████████████      ████     ██
████     █       █████           ██████      █████████           ███     ██████████        ███                          ████████ ████████  ████     ██
█████           █████           ████████    ████  █████████████            ██  █████       █                             ██████   ████████  ███     ██
███████  █      ██            ██████████    ████   ███████████                 █████                █           ██       █████    ████████          ██
███████████                 ████████████    ████    █████████                   ███                ███████     ████      ████      ██  ██           ██
████████████               ████████████      ███     ███  ██                                       ███████     █████     ███                        ██
█████████████              ███   ██████       ███    ██                                              █████     ██████    ████                       ██
██████████████             ██    ███████       ███   ██                                               ████    ███████     ███                       ██
███████████████    ██            ███████       ███   ██                 ██        ██    ███     ██    ███████████████      ██                       ██
███ ██████████    ████           ███████       ███   ██                ████       █████████          ███████████████      ████         █████        ██
██   █████████   █████            █████        ███   ██                ████        █████             ██████████  ██      █████  ███    ██████      ███
██   █████████   ████               ██        █████████           █     ███        ████              ██    ███         ███████ ██████ ████████    ████
█    █████████  ████                       ████████████          ███    ████        ███     ██              ██      █████████  ████████████████  █████
█   ██████████ ████                        ████ ██████           ███     ████        █     ███                     ██████████  █████████████████ █████
███████████████████            ██                ████            ███     ████████         ████                     █████████    ███████████████      █
█████    █████████             ██                 ███                     ██████         ██████                    ███████      ██████    ████      ██
████       ███████            ███                                          ██████       ██████████                  █████        █████    ███    █████
████        █████            ████                                           █████        ███  ████       ██     ██   ████    █    ██████████    ██████
████                        ████      ██                                    ████          ██   ███     ████     ███   ██    ███    ████████     ██████
█████              ██      ████       ███                            ███    ███           ██   ████ █████       ████       ███      ██████     ███████
█████             ███     ████        ███                           █████   ██            ████ ██████████       █████      ███      █████      ███████
█████    ██        █       ██         ███                           ██████                     ██████████        █████          ██  ████        ██████
█████   ███                ██         ███            ███           ███████                        ████████       ██████        █████████        ██████
█       ██                             ██            ████████      ███████                             ████       █████       ██████████         █████
█            ██                                   █   █████████    ███████                  ███         ███         ███      ███   ██████         ████
██           █    ███                    █       ███     ███████   ██████    ██        █████████         ██                 ███     █████          ███
██                ███                  ███       ████     ██████████████    █████     ██████████████                        ███                    ███
██    ██          ███             █████████       ████    ██████████████   ███████   ████████████████                        ███                   ███
██   ███           ██            █████████         ████   ████████   ███   ██████    ████████████████       █                 ██         ██         ██
██    █                           ██████            █████████████    ██     █        ████████████████      ███                          ███          █
██                                 ████             ███████ ███      ██              █████   ████████      ████████    ████          █ ███           █
███                        ███      ███        ██   █████            ███               █      ███████      █████████  ███████        ████            █
███                        ████               ████  ███               ██        ██                          ██████████████████         █            ██
███   ██                    ███               ████████                ███       ██                           █  ██████████████                     ███
███  ███                     ██           ██   ████████              ████   ██                                  █████████████                     ████
███  ████                            ███████       ████           █ █████   ██        █              ███        ██████████████       ██          █████
███ █████████         ███           ████████        ████   ████ ██████████ ████      ████           █████      ████████  ████████   ████        ██████
██████████████  ███  ████████████████████████ ████ ████████████████████████████████████████  █████████████    █████████  █████████████████████████████
██████████████████████████████████████████████████████████████████████████████████████████████████████████████████████████████████████████████████████
