████████████████████████████████████████████████████████████████████████████████████████████████████████████████████████████████████████████████████████████████████████████████████████████████████████████████████████████████████████████████████████████████████████████████████████
█ ██         ██  ████ ██ ████  █       ██ ██ ██ █  ██  █   ███      █    █ ██  █  ███ █  ████  ██  ██     ██ ██ █      █     █ █ █ █   ████ █        ██  █  ███   █ ██  ██  █ ████████      █   █  ██ █ █  █ █ █  ███   █ ███ ██████ █  ██  █ █  █ ██ █  ███ █   ██ █ ██    ██     █████
██ █        █ ██     ██ ██   ██ █  █    ███  ███ █       █  █   ██ █ █ █     ██ █   ██  █   ██  █    █ ███  █ █  █ ██   ██  █ █   █ ████ █ ███  █ █████  █ █        ██ █      ██     █   █  █ ███ █   ██  █ ██ ███   █ ██  ██ █   ██ █    █ ██ █ █ █  ████  █  █     █  ██  █    █  ████
██ █████        ██ █ ██  █  █ █  █ ██ ██ █ █    █   ███ █ █████    ██ ██ █ █ █ █  █   █       ████ ██    ██ █  █  █  █ ███  █    █ █   ██  ███  █  █    █ █  █ █ ██   ███ ██    █   ██  █  █ ███  ██  ███ ██ █ ██ ██ █ ███ ██    █  █  █      █████    ████    █ █    █ ██ █  █   █  ███
█ █  █      ███ █ ███  ████   █      █  █ █ █       █ █  █       █ █  █  ███ ██ █ █   ██ ███     █  ███████  █        ████ █  █  █  ████  ██ █████   █     █  ██ ██  ██ ██    ██ █   █ ██   ███  ██  █ ███  █ ██ ██ █   █  █ █ ██   █  ██ █    ████  █ ████ █    █ ███ ██ █ █        ███
██  ██    █   ██  ███████ █  █     █ ██ █      █ ██  ██ █       ████  █ █ █ █    █ ███████ █ █ █   █  ██  ██  ████ █ █    █  █  █   █ █  █    █  ██ ███ █   █   █ ███    ████ ██    █ █     ██    █ █    █ ███████ ██ █  █ █  ██       █   █ ██    █ █        █ ██  █ █  █      ██ ██ ██
█  ██  ████ █  █  █   ██ ████████ ██ █    ██ █  ██ █ ██ ██   █ █ █ █  █ █  █  █  █ █   █ ██  ██ █      ██ ███ ██ █ ██   █   ███ █      █ █    █  █  ██ ███  ████  █    ██ █ ███ █     ████   ███  █  █    █   █ █   ██  ██     █   ██ █ █   ██   ███ █ █    █ █  █ ███      ██ █   █ █ █
█ █     ███    █  █ ██ ██ █   █ █  ██   █     ████ ██ ██ █ █ █  █ █   ██  ██   ███ ███  ██    ███ ██ █  ██    █   █  █ ███████        ██     ██ ██ █   ███    █ ███ ██     █    ██ █ █  ████ ███  ██   ███  █ ███  █  ██ █   ██  ████  █ ██ █  ███ ██ ██ ███ ████    █ █ ██    ████ ████
█ █   █  ████    █ ███  ████ █  ██ █ █ ██ █ █    █ █  ██ █  █  ███  ███ ████   █  ██   █     █████ █ █     █ ██     █  ███   █ █  █  █   ██ █   █     █  ██ █ ██ █   █     █     █  █    █   █  █  █ ███  █ █     ███      ████ █ █  ███ ██ ██  █ ██ ██ ██ █ █   █  █   █ █ █ █      ███
████    ██  ██        █ ██ █████ ███  █ ██ ██   █ █ ████ ██ ██████ ███ ██  ███ █      ██████ █  ██   █ ██ █ ██       █  █████  █     ███ ███ █  █  █   ██  ██ ██  █ █ █ █ █ █    ████  ██ ██  ██ █ █  █ █      █    █  █  ██ ██ █ █  █  █     █   ████   █  █      █ █  ██ █████ ██    █
██   ██    █ █   █    █  █ █ ███ █████ █████  ███ ████ ████  ████ █   ██ █ ██ ██   ██   ████ █   ██ █   █       █     ██   ████ ██ █  █     ██       █ █  █ █ ██    ██   ██ █     ██  █ █ █ █    ███ █           █   █ █  █ ████   ███   █  █ █ █    █ ███ █ █  █   █  █  █  █ ███ █ █ █
█    █  █  ██ ██ ████ █  ██  ███  █ █  █ ███  ███ █    █  ███ ██  ██ ████ █  █ █ ██  ██     ██  █ █  █  ██  ████    ██       █ █   █    █  ███ ████   ██ ██ █ ██  █████  █  █  ██    █  █ █  ███ ██   █  ████ █ █ ██████  █   ██ █ ███  █  ██ █   █    █ ███   ██   ██ █ ████   █ █    █
█ ███ ██   █   █  ██  ██   ███    ██   █ ███ █████ █   █       ██   █     █ ███    ██   █  █ ███ █   ██       █ █ ██ ███████ █ ██ █ ██ █  █   █    █ █ █    █  █ █  █   ███ ████ █     █    █  ██ ██ ██     █ █     ██    █  █      ██  ██  ██  ████████  ███ ██ █   █ █  █      ███████
██  █   █ █    █ █         ██  ██  ███  █ ██  █       ███ ██ █  ███    █   █ █ █ ████████ ██ ██ █ █ ██ █   ██  ██  ██  █  █  █ █       ███ █ ██ ██ ███   ██     ██ █    ███ ██  ██   █            █ █      █   █ ██   ███  █  ██   ██  █ ██ █  ███  █    █ █     █ █ █  █     ██    █ ██
█  ██       ██  █  ██ █ █ ██  ███  ██   ███  █  ███ ██ ██ █ █       ██     ███ ██ █ █  █ █ █ ██  █  █ ████ ██ █     █    █ █ ██ ███   █ █ ██     ██ █ ████ █ █ █ █      █  ██ █████  █  ██████ █   █ █ ██   █ ██ ██          ██      ████ █   ██     █    █ █  ███ █   ███ █ █ █ ██ █ ██
█  ██ █  █   ███ █  ██   █ ████ █ ████ █ █     ██   ███  █ █ ████ ███ █ █  ████    █ ██ █     █ ██ █████         █    ██         ██      ████  ██  █ █      ██  █  █    █  ██ █████        ██     ██ ███ ███ ██ ██ ██     █  ██   █  █   █████ ██ ███  ██ ███   ██  █ █ █ █    █       █
█ ██ ██  ████ █ █   ██ ███ █ ███ █  ███████  █ █  █ ██ ███ ███ █  █ █ █ █    █   █ █   ██ ██ ██ █ ██ █     █  █ █   █      █  █  ███  █ ███ ██     █████ █  ██     █████  █ █  █      █    █  █ ███    █   ██  █ █████ █ █  █  █  ██ ███  ██  ████ ██ ██ █   █ █ █ █ █   █     █   █ ███
██ ███ ██ █   █       █     █ █ ██████ ███     █   ██   ██  █  ██ ██  █  ███ ████ ██ █ █   ██ █    █    ██  █ █     █ █ █  █  ███   █   ██ █ █ █   █ ███      █   ████ █ █ █       ██   ██  ██ ██   █  █  ██ █  ██      ██ █   ███ ██    █   █  ██  █   █ █         █     █ █ █ ███  █ █
███ █  ██ ██      ██   █ ███ █ █ █ █  █  ██ ██      ██ ██ ██ █            ███ █       █  ███ ███ █ ██  ██   █  ██ █   ███  ████  ██ ██ ██ █      ███ ██ ██ █  █ ██   █ ███  ██ █ ██ █      ███    ██   █ ███      ██  ██      █ █ █ █  █ ███  ████    █ █     ████   ██ ██  ███   ██   █
██ ██ ████    █ ██    █ █ █  ██     ████ ██ █     █ ███  █ ████    ███     █ ██ █ ██ ██ ██  ██ █  ███   ██  █  █ ██    █ ███   ███    █  █ ██   █  █  ██  █    █ █   █  █  ██ █   ██   ██   █ █ ███    █ ██   █ █  █   ███ █ █ █ ██ █ █████ ███  ███ █ █ █ █   ██  ██  ███  █ █ ██   █ █
████ █ █   ████ ██    █  █████ █ █   ██    █  █  █ █ █     █   ██  █   █ ████      █  █   ███   █ ██ █  █  ██   ██ ██   █  █ ██ █████  █  ████ █  ██ █ ██ ███    █    █████ ██  █  ███  ███   █ ██  █  █      █  ██ ██   █  ██  █ █ █     █    ██ ███        █████ █  █ █  █   ██  █ █ █
█     █ █ ██    █  █   ██   ██ █   █ █   █ █ █ █████ █   █  █   █ ███████   ████   ████ ██ █  ███          █  █ █ █   █ █   ███ ██  █ █ ██   █ █   █████ ██  ███  █ █████    █ ███ ██ █  █    █  █ ███ ██ ███ █ ███  █         █ █   ██  █  ██  █ █ █  █      █ █  █  █  ██ ██████  ████
█     █ ██ ████████   █   █ █ █████ █  █   █ ██ ███  ████     █   █ █   ███   ██  █ █       ██ ███   █  █  ██ █   █ ██  █  ███   ████ █ █ ██  ██ ███ █ ███  ██ ██ █ █  ██  █ █ █  ██ █  █   █ █  ██  ██ ███  █ ██    ███ ████  ███ █     █ ██ █ █  █ ███   █ █   █  ███   ███ ██ ██    █
██  ███     ██    ███     ███ █ ██    █      █ ███    █ ██ ███ ██   █ ██ █████ ██ █ █ █  █  █  █     ██ ███ █     ██   █  █  █   ███  █     █  ██ █  █ ██    █ █ ███ █    █ █  ████ █      █ ██    ███ █ ██  █ ██ █ █ █   ███     █    ████ █ █   █  █  █   █  █ █     █  ██  █ █   █  █
█████ ██ █ ██  ██ █ ██ ██   ███ ███     ██  █ █    ████  ██   ██ ██  ███   ███ ██    █   █ █ █   ███ █     ██      █    █ █ █ ███    █  ███ █    █ █ █ █ █  █ ████ ██  █   █           █ █   ████  █ █   ██ █ █     █  █ █  █ █ █ ███   █   ██     ██ ██  ██   ███  ███  ██████  ██ ████
██   █ ██ █ █   █ █ ██ ███ █    █████  █ ████  ██   ███  ██   ██ █  █  ██    █    █ █   ██   ██      ██     █ ███    █████████ ██ ███ ██ ██  █ █ ██         █ █ █ ██ ██ ████  █   ██      ███   █ ██ ██ █ ██ █   █  ███  █ █   ██████████ █     ████ ███   █  █   █  █████████ █ ██   ██
█ █     ██     ██   ██ █  ██ ███ █ █  █████ █   ██    █ ██  ██ ██ ██      █ █  █ ██ █ █ █       █  ██  █   ██ █  █  ██    █   █ ██ █ █ █ █   ███ █ ██ █ ██      ██ █  ██ █ █ █   ███ ██ ██    █ ██ █   █ █  █    █  ██  ██ ███ █  ███    █ █     █ █  ██ ██ █  █  ██    █ █  █  ██   ███
██ █   ██████ █████████████  █ ████   █ ███ █   █ ███  █ ███ ██    ███ █ █   ██ █   █ ██   ██ █   ██ █ ███   ██████ ██  █       █ ██ ████ ██████  ███  █ █  ██  █ ████    ███  ████████ █   █    █  █  ██ █   █     █ █  ██    █  ██  ██   ██  █ █ ██ ██    █ █ ██ █ █     █ █    ██████
███   ███   █  █   █ ████   ██ █ ██  █ █  ███  █ ██ ██   █ ███ █ █  █ █ ██  █  ███   ██ ██ █ █ █  █ █    ██  █  █   █ █     █  ███  █  █ █ ████   ███  █     █  ██   █ █   █   ██   ██ █  █  █      █ ████ ██     ███ █████   █    █  ██   █  ██  ██     █ ███ ████ █   ██ █  █ ██     █
█ ███    █      ██    █ ███ ███ █   ███   █ █ ██   █  ██  ██ █  █  █   █ ██ █ █ █  ██  █   ██    █ █ █  ████  ███ █        █  ██  ███████ ██  █ ███ ███    █ ██ █ ████  ███   ██   ████  ██ █ █    █    █ █ █   █   █  ███ █  ██ █     ███ ██  █ ███  ██ ███  ██ ██ █████ ████ █     █ █
██ ███          █  ██ ██ █ ███ ██ █ ██ █  ██ █  ██ ████ ███  ██ █ █  █  █ █      █  █ █ █ ██       ██  ██           ██     █  ███ █  ██ ██           █ █ █████     ████  ██ █       ███ █ █ █ █  █ █    █ █    ███ ██ █ █ █ ██ ████   ██   █  █ ███   █ █ ███ ████   █ █  ██ ██   ████ █
█ █   █ █   █ █ █ █       █  ██ █ ███    ██ █     █ ███  █  █  █    █     █   ███ ███    █ █  █       █  ██  ███ █ ███ ██████ ████   ██   ██ █ █ ███   █   █    █████  █   █   █ ███  ██   ██ █ ███ █  ██ ██████  ██ █  █ ██ █   █  ████  █   ██     █ ████████  ███ ██  ██ █   █  █  ██
█     █  █ █ ██ ███  ████  ████   █ ██ ██     █  █ ████  ██████ █   █    ██   ██  █           █         ███████ █   ██ █  ███ ██ █ █ ███ ██ █   ████ █ █ █  ██ █ ██ █   █ █  ██    ███  █ █      █ █    █      █ ███ ██   ██      █  ████ █ █ █ █ ███ █ ██   ████  █ ██ █ ██      █ ██ █
█ ██ █ █         ██  █    █  █████ █    ████ █     ██ █ █ ██       ███ ██  ███   █ ██  ██ █ ██  █ █ ██ █ ██ █ ███       █  █    █ █  ██ ██████   █  ██ █  ██ ██ ██ █ █  █  █ █   █   █ ███  █████ ██  █          █ ███       ██ ██  ████ ███    ███      ██ █    ██   ███   ██ ██  █   █
█ ██  █  ██  ████ ██  █ ██  █    ███  █ █    ██     ███     █   █  █  ██   █  ██ █ █ ████ ███ █ ██ █ ██     ██  █     █  ███ █  █   █  █ █  ███  ██  █ ██ █ █    █    ██    █     █████   ███   ████ ███   ███ █ █  █ █ ██ ██ █ ██    ██  ██   ██  ███  ██ ██   ██   ██  █ █  ██ ██ █ ██
██ ██  █  ████  ██ █ ██████ ███     █ █    █████  █ █    █ █ ██  █ ████ ███ ████    █     ███ ██  █    █ █ ██   ██ █  ██  ███  █     █ █ █ █ █   ██ █    █ █   █  ██ █  █ █  ██  █  █  █   █        ██    █ █     ██ █ █        ██   █    ███ ██ ██ █   █ ██ █   ██  ██ █  █    ██    ██
█  █   ██ ██ ██      ██ █████ ████      ██ █ ███  █ █ ██  █  █       █ █  █  █ █       █   █   █████ █      ██ █   ██  █ ██ █       █      █  █   █ █  ████  ███ ██ ███ ███ █   █     █   ██   █ █ █    █████ ██ █   ██    █   ██████ █    █ █ ██  █    █  █  █      ███  █  █         █
██  █     ██   ███  █  █ ██ ██ █   █ █    █      █ █             █████   ████  █████ █ ██ ██    █ ██ █    ██ ███  █    █  ████  ██  ██   ██       ██   █   ████   ████    █  █   ██ █ ██   █ █   ████ ███ █     █ █ █  █  █  █████   ██   █  █ ██ █ ██     █  ███████ █  ██  █ █   ███ █
█  ██  ███  █ ████ ██    █     █   █       █   █   ████  █ █ ███████  █  ████  █  █████ █  ██  ██     █ █ █ █ ███ █ █ ████████ █ ██ █   █ ██ █ █ █     █ ██  ███   ██   ██ █ ███ ██  █ ████ █    █████   █      █  █  █ ██ █     █ █      █   ███ █ █    ██ ██   ███ █  █  ██  █   █  ██
██       █       █   ████ █ ██      ███   ██ █ █ █ █   ██  █ ██    █   █       █   █  █ █ █ █ █  ███     █ █████ █   ███   █ █ ██      █ █    ██   ██ █   █  ██ ██ █     █ ██ ███  ████ █ █     █         █   █ ███ █   ██  █  █  ███     █  █   █   █  █ ████   ██    █  █    █   ██  █
█  █ ██   ████     ██  ███████  █ ██  █  ██          █  ██  █    █ ██ ██ ██   ██     █ █  █ ██ ███ █ ██  ██   ███ ██    █ ██  █  ██ ██ █ ██ █   █     █  ████ █  █ █    █   ██   █ █    ██ █ █   █   ███ █ █    ███    ██  █     ███  ████        █   ██ █ ███ █ ██  ███ █    ██ ██  ███
███ █      ██  █   █ █   ██ █   █ █  █  █   █ ██  ████ █    ██    ██    ████ ███████ █ ███████  ██ █  ██   █  █ ██   █ ██     █  █   █  █ ██      █      █ █ █     ██   ██  █  █ █  ██  █  █ ████ ███   █  █ █    █ ███        █    █ ████    ██  █  █  █ ███ █  █   ██████  ██ █ █  ███
████       ██      ██ █  ████ ███    █ ██  █      █ ██ ███ █████     █  ███ █   █ █ █████   ██        █  ██████    █  █ ██   ██  █  █ █ █   ██   ███          █   ███       ███   █  ████ ██  █ ███   ███ █  ██   █   ██ ██ ██ █       █      ██      █     █ ██   █ ██  █ █      ██ █ █
██     █ ████ ██ ███  █ █ █  █   █  █ ██ █  █ █    █         █ ████ ████  █ █ █ █      █ █   ██ █   ██       █ ████  █ █  █  ██  █ █  ██       ████         ███      ██ █  ██ █  █ ████ █   █ █  ██ ███ █ ██  ██ █     ███   ██  █ ██ █ ██████   ██ ███  ██ ████  █     █   ███ █ ██████
██ █ ██ ███ ███ █       ██   █ █  ███ █ █ ██    █    █     ███  █   ████ ██  ██ █   ██   █ ██ █ █  ██  ██   █  █      ███  █  █  █     █ ██ █ ███ █ █     █  ██    ██   █████ ██     █ ██ █ ██  ██ █ █ ██ █    ██  █    ███  ████ █ █  █  ██  ██████ █     ██   █     █ █  ███  █      █
█  ███   █   ██  ██   █   █ █  █       ██  █ ████ ███  █ █ ███  ██    █   ███ █  █  █   ██ █ █  ████  █ █ ██  █ █ ███  █    █  █ ██ ██     █  ███ █  █  █ ██   ███ ██   ██  █ █ █  █   ██  ████ ███ ███ █   █   ██  █     █ ████ ██  █ █  █  ██ █  █     █  ██ ██    ██ ███ ██   ██ █ ██
█   ███  █ ██     ██   █  █    █  █  █  █ ███    ██   █        █    █    ███ █       ██  █  ███ ██ ████   ██       ██  ███ ███  ██   ██ █  █ ██ ██ █   ██ █   ████ █   ████       █  ███    █ ███   █  █ █  ██    █   █       ██    ███  █ █ ███    ███    ███   █  ██ █ █ █  ██     ███
██  ██ █  ██    █  ██  █ █ ██     █  █  █ █  █ ███  █ █████ █ ██       █ █   █   ██ ██   █  █ █   █ █ █ ██ █ █ █    █ █ █  ███████ ██  ██ ██     █  █ █████ █  ██ █ ███    ████      ██  █ ████ █  █  █    ███  ████ ██ █ █   █ █ ███ ██ █       █  █ ██    ██  █ █  █  █  █  ██ ██  ███
██  █ ███  ███    █    █ █  █████      ██ █████   ██ ██     ██ █      ██  ██   ██ ██  █  ██ ██ █ █  ██  ██  ███ █ ██ ███ ███ █ █   ██ █ █ ██  █    █  █████       █ ██    █   █████ █████   █ █   ███ █     █████ █     ██ ██ █    █   ██  ██      █████ ██    ██   █     █   █     █ ██
██ ███  █  █ █  █ ██ █   █   ██   █   █ █ ██  ██ █       █  █   ██ █   █    ███ █ █ █████   █ █  █  ██ ██ ██  █     █  ██ ██ ████ █      █   ██     █ ████       ██ █  ███ ██  █  █      █       ██ █ ██  █    ██ ██       █ ███ █ █    ███    ██ ████  █   █ █ ███  ██ ██ █  █ █    ███
█      ███       ██  ███    █  █  █  ██ █     ████  █     ████    █ █  █ █     ██ ███    █    █ ████    █ █ █  ██  ██ ███    ██ █   █ █ █   █  ██  ██  ███    █ ██   █     █  ██    █  █    █  ████ ██  ██ █████      █  █  █   ███ ██  █   ██   █  ██   ███    █  ██  █████ █ █    ██ █
█  █ █ █ █    █ █     ███    █ ███    ██  █ █ ███ █  █  █ █  █ ████  ███   ██     █   ████   █  ███    █ █ █  █ ████ █   █   █ ███     ██████ ██ █ █ █    ███     ██   █    ██    █ ████████ █    █   █ ███    ██    █ █ █  █    ██ ██ ██████ █ █ █ ██  ██ █ ███  █ █  █  █ █  █ █  █ ██
███    ███   █  ██ █ ██  ███ ███      ███ █  ███    █   █ █   █ █  █ ██ █  █ █ █  ████  ██ █     █ ██   █ █ █ █       █    █ █ █  ███   ██  ██      █       ██ █  █  █ ███   █ ███ ██ █  █ █████  █ ██   █  █ ██ █ █ █ █ █  █  █  ██     █   █  █ █ ███ █   █ █  ████   ██    █   ██ ███
█ ██ ██ █ ██ ███   █ ███   █   █ █  █  █ ██  ███ █  ████ ██   ███████  ██ █  ███     █ ██ █   █   ██   ███ █ █ █ █ ███ ██   ███ █    ████   ████  ████  █  ██  █     █ █   █  ████    █  ██   █    ████████   █   █ █   █ █  █  ███   ██ █        ██  █    ██     █ █  █ ███ █ ███ █   █
█ ██       █ ██     ██  █ █ █  █████  ███     █   ██ █    █   █ █ █   █ ██   █ █ █ █ ██ █ ██   ███ █     █   █ ███  █ ████ ███████ █ █ █  ██████  ██ ██  ██    █  █████  ██   █ █ █      █ ███         ███ ██  █   █ ██  ███  ████   ██   █ █ █ █              ███ ███   █ ██   █   ████
█ █ ██     █ ██  ██ █ █  ████████   █   █ ██ █   █   ███ █ ██    █   █ ██ █ █ █  ███    █  █     ███  █    █ █    ██ █  █   █ █    █ ██ █   █     █ █    █  ██ ███████ ████ ██   ██  ███ █ ██    ██  █ ██      ██ ███    ██  █  █ ██      ██ █  ███     █   ██ ███     █ █  █ █ █   ████
█ █  █████ █ ███       ██ █ █   ███ █  ██     █    █ ███ ███  █ █ █      ██  ██  █    █  █ ██ █ █ ██     ████ ██ █     ██  █ ██ ████   ██ ███      █     ███  ██████ ██  ███  █   ███  █ ████     █  █   ██  █ █ █       █   █      ███  █  █ █ █    █ ██   █   █  █    █   █ ██ ██ ██ █
███  █  █     █   ██   █   █  ███    █    █  ██ ████ ██ ████     ██  █ █     ██ █████   ██    █   █  █     ██  ██   █    ██   █    █  █ █  ██ ██ █    ███ ██ █ █  █  █ █ █  █ █   ██ █ █ █ █ █ █  █    ██ ██  █   ████  █  █   █   █  ███ █████ █ ██  ██   █  █  █ █ ███ █ █  █ █  █ █ █
████  █   █  ██ █ █ ██  ██ ██    █    ███ ██  ███ █   ██ █   ███ ████  ███   █  ██    █ █  ███  █ █ ██ █    ███   ██  █    █ █████     ██ ████ ██ ██ █ ██ █   ████ █  █      █ █   █ █      █ █████  █     ██████    ██ ██   ██           █ ██        █ █ █  ██ █  ███ █ █  █ ████  ██ █
█  █ ██ ██ ██  █ █   ████  █   ███ █    ██  █  ██      █   █ █  ████  █ █ ██ █ █    █ █      █ █ █     ███ ███    ██ ███ ██      █  █ █  █  █████    ██  █████████ █  █   ███ ██ █████ ███ █     ████    ██ █   █   ███████ ███ ████   ██ █ █████ █ █      █   ██ ██ █ ██ ██ █ ███ █   █
█ █   █ █████   █ █  █  ███ █     █  ██ ██    ██ █ █ █  █ █  ███  █ █ █ █  █████ █  █  ██████  █ █ █ █  █  ██   █ █  ██ ████    ██ █   █    █   █    ███ ██    █ █ █ ███ █   █ ██ █ █    █ █         ██      █      █ █ ██     █ █ ███ █████  ██   █  █████   ███   ███  █     ██  ██  █
████   █  █   █ █  █ █ █ ██  █ █      ██   █ █ █  █ ██      ██  ██ ██      ████████ █  ████  █ █   ██ █     █ ██   █  █           █  █    █  █ █  █  ██       █  ██     ██ █ █     █ █ ████          ██ █  █  █ █ █ ██   ████ █████ █ █ █ █ █  █ ███ █  █   ██ █   █   █  █  ██    █   █
█ ██ ██      ██ █   █ █ █ ███  █ █ █  ███ █    ██ ███████ █ █ █ ██████ ██ █   ███        ██ ██  ███    ██  ██████     █   ██ █  █    █    ██   ██   █ ████    ██  ██  ██  █ ███    ████ ██    ███  █  █ ██   ██    █ █       ███   ████  █ ██  █ ██  ██  ██    ███  ███  ██        ██  █
█   ███     █      █  █  █  █ █ █████ ██    █  █   ███ █  ████ █ █  █ █ █ █   █     █ █ █ █ ██   ██████ █  ████   ██  ███     ███   █      █ █ ███ ██   ████ ██  ██ █  ███   ██ █ ██ █ ██████    █ █ ███████   █ █       ██ ██  ██   █    █    ███ █   █ ██ ███   █ █     ███ ███ ██ █ █
█ █ █  ████████  █████  █  █████     █  █  █  █   █ █████        █ █████ ███ ██  █ █  █████████    ███ ██ ██ ███ █ █ █   ██ █ ██ █  ██ ███  █ ███ █  █    ██   █ ██ █  █ █████  ███████ █ ██  █   █ █  ██     █  ██  ███   █  █  █ ██ █████   ██████ ████ ██ █    ████ ██ ██   ██ ██   █
████ █  █    █ ████ ██   █████ █  █  ██   █  █   █ █ █       █         █ ███   █  ██   █   █ █ ███            ████████   ███     █ █  █     ██ █      ██  █ ██ █ █ █     ██ █ █████  █ █     █    █   █  ██ ██ ███ ██    █ █  ███ █   █ ██  ██  █  █  ██  ████████            ██    ████
█  ██ █ █      ██   █  █  █   █      █ ██         █ █   █  ██  ███ ██ ██ █  █ ████  █   ██  █   █ █████ █    █   █  ██ ███ █ █ ███ ██ ████ █    █     █████ █  ██ ██  ██  ██     ██ ██ █  █  █   █ ███ █ █ █ █ ██ ███ ███████   █  ███ █   █ ██  █       ██  ████    ██ █ ████ ██ █ ████
████████████████████████████████████████████████████████████████████████████████████████████████████████████████████████████████████████████████████████████████████████████████████████████████████████████████████████████████████████████████████████████████████████████████████████
