██████████████████████████████████████████████████████████████████████████████████████████████████████████████████████████████████████████████████████
██████████████████████████████████████████████████████████████████   ███████████████████████████████  ██████████████████████████████████  ████████████
██████████████████████   █████  ███████████████████████████████          ████████    █████  ██████     ████████████   ████████████          ██████████
█████████████████         ███    █████████████████████████                                   ██        ████████          █████               ████  ███
███   ███████                     ████████████████████                                                  ██████            ██                  ██    ██
██     █████        ███            █████████████████                        ███████   ██                 █████                 ███                  ██
██     █████      █████              ██████████████                 ██     ██████████████                ████                 █████                 ██
██      ████    ███████               ████████████                 ███    ████████████████               ████                 █████                  █
██       ██    ████                       ██                  ██  ███    █████████████████         ██     ██                  ████                   █
██             ███               ████                        ████████   ██████████████████        ████                        █████                  █
██             ███               █████       █████████       ████████   ██████████████████        ███████                     ██████████            ██
███           █████  ████       ███████    ████████████     ███████████████████████████████      █████████          █████     ███████████   ██████████
██████████  ████████████████████████████████████████████  █████████████████████████████████████████████████   ████████████   █████████████████████████
██████████████████████████████████████████████████████████████████████████████████████████████████████████████████████████████████████████████████████
