██████████████████████████████████████████████████████████████████████████████████████████ █████████████████████████████████████████████████████████████████████████████████████████████████████████████████████████████████████████████████████████████████████████████████████████████
███████████████████    ███████████████████████  ████  ███████████████████████████████████   ███████          ███████████████  █████████████████████████████████████████   █████████████████████████████████████████████████████   █████████████ ████████████████████████████████████████
█████████████████                       █████          ████████      ████    ████████                         █████   █████       ██████     ███   ██   ██████  █████             █████████████████████        ████   ███████             ████             ███████████  █████ ██████████
███████   ███████                         ██                                 ███████                                    ██         ████                 █████    ███               █████████    ██████                 ██████              ███              █████  ██     ██   █████████
███████   ███████                                                            ███████                                               ████                ██████                      ████████      █████                  █████              ████              ███               ███   ███
██████     ████████                ██                                       █████████                      ██  ████                 ███               ██████                       ████████       ████                   ████████           ████                              ███    ███
██████       ███████              ████                                      ████   █          ███          █████████   ███          ███              ██████                       ████████        ████       ████         ████████          █████                            ███      ██
██████        ██████              ████                                     ████              ██████         ███████████████        ████             ██████                       ██████          ████       ██████        ████████           █████  █████                    ██       ██
███████       █████               ████                    ███            █████              ████████        █████████████████      █████            █████                        █████          █████      ████████       █████████            ███████████                   ██       ██
████████     ████            █     ██                    █████          ██████             █████████       █████  █████████████    ███████          ████                        ██████         ██████     █████████        ████████             ██████████                           ███
█████████     ██             █             █████        ██████         ██████             █████   ██       ████     ███████████████████████         ████                        ██████         ██████   ████████████       ████████   ██         ████████                           ████
██████████                                 ██████       ██████         ████               ████             ████      ███████████████████████         ███                        ██████        ██████   █████████████      ███   ████ ████         █████                             ████
██████████                                  █████        ████         ███                  ██               ███      ████  ██████████████████         ██                         █████         ██      █████████████      ███    ████████         ███                               ████
████████                                     ███                     ███                                     ██       ██    ████  ██████████          ██                          █████                 ████████████       █      ██████                                             ███
██████                               ██           ██               █████                                     ██       ██    ███    ████████           ██                           █████████             ███████████              █████                                               ██
████                                ████         ████             █████          █                                    ██    ██     ███████           ███                    ██      █████████       █         ███████             █████                                                █
███                 ██              █████       ██████           █████           █                                    ██           ██████          █████               ███████       ████████      ███          █████            █████                                        █████    █
███                 ███            ██████       ███████          ████                                                ███           ██████         ██████          ██   ███████       ████████     ███            ████            █████                            ████       ███████  ██
███                █████    █     ███████       ███████           ██                                              ███████          █████          ██████         ████████████       ███  ████     ██             ████       ██   █████    ███                    ███████      ██████████
██     █████       ██████  ███    ██████           ████           ██                                             █████████          ████           ████      ███████████████       ███    ██     ██              ████       ██   █████    ███                   █████████          █████
██    ███████      ██████████    ███████           ████                     ██                                 ███████████                  ██     ████     ████████████████      ████          ██              █████      ███   █████    ███                   ██████████           ███
███  ████████      ██████████    ████████          ███                      ███                       ████  ███████████████                █████  ██████   ███████   ████████    █████         ███            ███████    ██████   ████    ███                          ███            ██
████████████       ██████████    ██████████       ███                        █     ██                ██████████████████████               ███████████████████████      ██████   ██████        █████           ███████   ███████    ███   ███       ██      ██           ██            ██
████████████       ████ ██████  ███    █████      ███                             ████               ██████████████████████     ████      ████████████████████          ████    ██████       ██████           ██████    ███████     █   ████      ████    ████                        ██
█████████████     ████   █████████       ██████  ████                             █████████   ███    ██████████████████████    ███████   ███   █████████████            ███     ██████       █████           ██████      ██████         ████   ███████    ████                        ██
██████████████████████   ████████         ███████████                             ██████████ ████   █████  █████████████████   █████████████   ████████████             ███      ████         ███            ██████         ██           ██   ████████     ██                        ███
██  █████████████████    ███████           ██████████      ██                    ████████████████   ████     ███████████████    ███████████    ███████████         ██   ██                                    █████                          █████████                    █████      ███
█    █████████████       ████              ██████████     ████        █          █████████████████  ████     ███████████████     █████████     ██████████         ████████                                     ████      █                   █████████                   ██████      ███
█      ██                 ██                █████████      ██       ████        ██████████   ██████  ██       ██████████████     ████████      ██████████         █████████                ██                   ██      █████                ███   ███                   ███         ███
██                                              █████              █████        █████████      ████           █████████████     ████████       █████████          █████████               ████                          ██████               ██     ██                ███           ████
█████                                            ███              █████   ███    █████          ████           ██████  ██       ███████         ██████             █████████              █████                        ███████              ███     ██               ████           ████
███████                                                           ██████ ████    ████      ██    ████    ██     ███              █████          █████              ██████████   ████      █████                     ██████████             ████             █████     ███           ████
████████           ██          █████                             ███████████      ██      █████   ███   ███                        ██          █████       ███     █████ ████  █████      ██████                   ██████████              ███             ███████     █             ███
███████           ██████      ██████                             ███████████              ██████ ██████████                                    █████      █████    ████   ███  ████       ██████                   ██████████              ███           █████████                    ██
██  ██            ███████     ██████                              ██████████               ████████████████                                    ████       █████     ██     █   ████        ██████                   █    ████              ███       ████████████                      █
██                ███████     ████           ████                  ████████                 ██████████████                                     ████       ██████               ████        ███████                        ███                      ████████         ███                █
██                 ██████     ███           ███████                ███████                   █████████████                      █               ██         ██████              ████         ██████      █                  ██                     ████████         █████   ██         ██
██                   ████    ████          ████  ███              ████████                   █████████████       █        ██   ███                           █████             ███             ██      ███          █      ██                     ███████          ███████████       ███
███                         █████          ███    ███            █████████                    ██   ███████               ████   ████████                      █████            ███                     ███        ████    ███       █             ██████      ██    ██████████       ███
████                        ████            ██     ██           ████████████           ██           █████              ███████  █████████                      ████            ███                    ████      ███████   ████     ██              █████     ████    █████████        ██
████     ██                                 ██                  █████████████          █              ██              ████████   ███  ████      ███             ███                                  ██████     ███████   ████      █        ██     ████     ████    █████████        ██
████     ██                                 ███                 █████████████                                         ███████          ████    █████     █      ███      █                          ████████      ████████████              ████    ███     █████    ██████████      ███
████    ███                                 ████                 ████████████                              ██         █████            █████  ██████    ███             ███                         ████████       ██████████              █████   ████     █████    ████  █████████████
███     ████   ██              ██           █████                  █████████                            ███████      █████             ████████████     ███             █████████                    ███  █           ██████               ███████████      ████     ███    ████████████
███     ██████████           █████           ████     ██             █████                              ████████    ████               ██████████                        █████████                                     █████               ███████████      ███      ███     ███████████
████    ██████████          ██████            ██     ████                                      █           █████    ███                █████████                          ██████████              ██                     ███     ██        ███████████       █       ██       ███    ███
█████   █████████           █████                    ████                                     ███           ███    ████                █████████      ██            ██     █████████     ███     ████                     ██    ████        ██████████                                ██
██████  ████████            ████                      ██                                       █                   █████                ████████     ████         █████     ████████     ████    █████                          █████       ██████████                          ███   ██
██████   █████               ████  █                       ███                 ██                                   █████                ██████      ████        ██████      ████        █████   ██████                          ████       ██████████                         █████████
██████     ██                 ███████                     █████               ████      █                            ████                 █████     █████       ██████                   █████    █████████                       ████      ██████████     ██                  █████████
██████                        ███████          █         ██████     ██       █████     ███       ███                  ███                  ███     ██████      ███                       ██████    █████████                      █████      ████         ███████              █████████
██████                         █████                    ███████    ████     █████      ███     ██████       █                     █                █████      ███                        ██████     ████████                      █████       ██         █████████     ███      ████████
█████    ███                   ████                     █   ███   ██████   ████        ███   █████████     ███    █       ████   ███              ████       ████                         █████      ██████                      ██████                 ██████████     ███       ███████
████    █████                   ███                          ███  ██████    █      █████████████    ███    ███   ███     ███████████              ███       ████                          ██████                                ████████               ████████████    ███       ███████
████    ██████                   ██                          ███   ████           █████████████      █     ██████████    ███████████              ██       ████                           ██████                                █████████              ████████████     ██       ███████
█████    ████                     █    ████                  ███                  █████████████            ███████████    ████   ███              ██      █████    ████             ███  ██████                                  █████████       ██   ████      ██              ████████
█████                        █    ██   █████                 ███                  █████████████            ████████████           ██               ██     █████████████             █████████                ███                 █████████      ████  ████                      ████████
█████                      ████   ██    ███                   ███      █          ██████████████   ████    ████████████           ██               ███    █████████████              ███████           █     ███                 █████████      ████   ███                      ████████
█████                  ████████  ███                          █████   ████         ██████████████████████   ███  ██████          ███    ██         ███     ██████████                 ████                   ██                 ██████████     ████     ██                      ████  ██
█████                 █████████  ███                  ███      █████  █████        ███████████████████████   █    ██████         ██    ███████████████      ████████                                                            █████████      ████     ███         ██           ██   ██
█████    ██           ████████   ███                 █████     █████  ██████        ██████████████████████         █████████            ███████████████          ███                           █████                            █████████       ██      ████       ████               ██
█████   ████   █     ███████     ████                ███████  █████    █████         ████          ██████           █████████             ██   █████████          ███                         ███████                 ████       ███████                ████       ████               ██
████    ████  ███   ███████      █████                █████████████    █████                        █████            ██  ████                   █████████         ██████████   ███             ██████                ██████       █████                  ██        ███                ██
███     ████   █   ████████       █████       ███      ████████████    ██████             ███       █████    ██           ████                   ████████         ████████████████             ██████                ██████       ████                             ██                 ██
███    █████       ████████       █████      █████      ████████████  ███████            █████     ██████   ████  ███     █████                  ████████        █████████████████            ████████    ███        ██████       ████                            ███                ███
███   ███████      █████████     ██████     ███████     ██████████████████████          ██████████████████████████████   ████████   ██          █████████    ██████████████████████         ██████████████████       ███████     ██████        ██████      ███████████             █████
████████████████  ██████████████████████   █████████   █████████████████████████████████████████████████████████████████████████████████   ███████████████  ████████████████████████████████████████████████████████████████████████████████████████████████████████████████   █████████
█████████████████████████████████████████████████████████████████████████████████████████████████████████████████████████████████████████████████████████████████████████████████████████████████████████████████████████████████████████████████████████████████████████████ ██████████
