████████████████████████████████████████████████████████████████████████████████████████████████████████████████████████████████████████████████████████████████████████████████████████████████████████
████████████████████████████████████████████████████████████████████████████████████████████████  ██████████████████████████████████████████████████████████████████████████████████████████████████████
███████████████████████████████████  ███████████        ██████████████████████████████████████     ███████████████████████████████████████████  ███████████████     █████        ███████████████████████
██  ██  ████████████████████████      █████████          ████████████████████████████████████       ██████████████████████    ███████████████    █████████████       ██           ██████████████████████
█        ██████████████████████        ███  ██           ████████████  ██████████████████████        █████████   ████████      ██████████████     ████████████                    ██████████████  ██████
█        ██████████████████████                          ███████████    ████████████████  ████        ███         █████        ███████████████     ███████████                    ████████████     █████
██   ██   ████████████  ██████                           ███████████     █████████████     ███                    ████        █████████████████     █████████             ███      ██  ██          █████
████████  ███████████    █████                    ██     ██████████      ████████████      ███    ██              ████       ██████████████████     ████████             █████                     █████
████████   ██████████    █████                   ████     ████████       ███████████      ███    ████            ██████      █████████████████     ████████              █████                    ██████
████████    █████████    █████            ███    ████     ████████      ███████████      ███     █████           ██████       ███████████████     ████████               █████               ██  ███████
███████     ████████    ██████          ██████  ████      ████████     █████  ████      ████      █████          █████         ██████████████    █████████                ███             ██████████████
██████       ██████     ███████        ████████████      ███   ██      ████    ██      █████       █████          ███           ████████████     ██████████                              ███████████████
████          █████      ██████        ████████████     ███             ██             ██████      █████                        █████             ████████████                          ████████████████
███           █████      ██████        ████████████     ███                             █████      █████                         ██               ██████████████    ███               ██████████████████
███          ███████     ██████        █████████████    ███     ██                       ████       █████               ██                       ███████████████████████             █████████████   ███
████        █████████   ████████       █████████████     ███  █████                      ████       ██████             ████                     █████████████████████████           █████████████     ██
████        █████████████████████     ██████████████      █████████                      ████      ███████          ███████                     █████████  ██████████████          ██████████████      █
███         █████████████████████    ██████████████        ███████                        ██      ████████         █████████                   █████████    █████████████         ██████████████       █
██          █████████████████████   ███████████        ██   ██████                               ████████          ██████████                 ████████      ████    █████         ██████████████      ██
██           ██   ███████████████  ███████████        ████   ██████                              ████████           ██████████              █████████        ██      ███           ██████████████    ███
██                    ██████████   ██████████         ████   ██████                             ██████████            █████████            █████████                                █████████████    ███
██                     █████████   ████████            ██    ██████                             ████████████           █████████          ██████████                                █████████████    ███
███          ██████     ███████    ███████                   ███████        ██                  █████████████             ████████        ███████████                               ███████  ████    ███
██████     █████████     ███       ███████                   █████████     ████           ██    █████████████     ██       ████████        ██████████████                          ███████    ██     ███
████████  ██████████                ██████                    █████████████████          ████   ██████████████  █████       ███████         ██████████████                        ████████    ██    ████
███████████████████                   ████                    ████████████████           ████   █████████████████████        ██████    ██   ██████████████                       ██████████  ███    ████
██████████████                         ███                     ██████████████           ████    █████████████████████           ████  ████   █████████████      ██              ████████████████     ███
█████████████                          ███    ██               ███  ███████          ███████    ███████  █████████████           █████████   █████████████    █████       ██████████████████████      ██
█████████████                         ███    ████             ███    █████          █████████    █████    ████████████            ████████   ██████████████  ███████     ████████████████████████     ██
████  ███████     ████        ███    ███    ██████     ██    ███      ███      ██   ██████████            ████████████            ███████    ████████████████████████    ██████████   ████████████    ██
███    ██████    ██████      █████████     ███████████████  ████              ████  ███████████          █████████████            ███████    ████████████████████████    █████████     ████   █████  ███
███     ████     ███████     ████████      █████████████████████             ██████  ███████████      █████████████████  ██       ████████  ████████████████████████    █████████              █████████
███              ████████   █████████       ███████████████████              ██████       ██████████████████████████████████      ███████████████  ██   ████████████    ████████               █████████
██               █████████████████████         ████████████████               █████        █████████████████████████████████      ██████████████         ████   ████    ███████                █████████
██              ███████████████████████          ██████████████               ████          ████████    ███████████████████      ██████████████                  ██     █████                  █████████
██           ██████████████████████████              ██████████               ████           █████        ████████████████     ████████  ████                          █████                   █████████
██          ████████████████████████████              ███  ███        ██     ██████           ███          ███████████████    ████████    ██                           █████                   █████████
███         ████████████████████████████                             ████████████████         ███          ██████████████     ████████                                 ██████                 ██████████
████         ███████████████████████████                             █████████████████       █████         █████████████       ████████                                 ██████                ██████████
█████         ████████████████  ████████                         ██   █████████████████     ███████        ████████████        ███████████                              ███████              ███████████
███████       ███████████████    ███████                        ████       █████████████████████████      ████████████        █████████████    ██                       ███████             ████████████
████████      ██████████████     ████████                       █████       █████████████████████████    █████████████       ███████████████  ████                     ███████            ██████████████
████████     ███████████         ████████████            ██      ██████      █████████████████████████  ███████████████      █████████████████████                    ████████    ██     ███████████████
███████    ██████             ████████████████    ██████████     ███████     ███████████████████  ██████████████████████     █████████████████████                 ██████████    ████   ████████████████
██████    ██████             █████████████████   ███████████    █████████   █████████████  ████    ██████████████████████    ███████   ██████████                 ███████       ████████████████████████
██████    ██████             ████████████████    ████████████  ████████████████████████     ███     ██████████████████████  ███████     █████████    █████████   █████         █████████████████████████
██████    ███████     ███   █████████████████    █████████████████████████████████████      ███     ███████████████████████████████     ██████████  █████████████████         ██████████████████████████
███████  █████████   █████████████████████████  ██████████████████████████████████████     █████   █████████████████████████████████   ██████████████████████████████       ████████████████████████████
███████████████████████████████████████████████████████████████████████████████████████  █████████████████████████████████████████████████████████████████████████████   ███████████████████████████████
████████████████████████████████████████████████████████████████████████████████████████████████████████████████████████████████████████████████████████████████████████████████████████████████████████
