████████████████████████████████████████████████████████████████████████████████████████████████████████████████████████████████████████████████████████████████████████████████████████████████████████████████████████████████████████████████████████████████████████████████████████
██████ ████████████████    ██████  ██████████████████████████████████████████████████  █████████████   ███████████████        ██████████████████████████████ ██████████  ████████████████     █████████  ████████████    ███████████████████          ████████████████████████████   ███
███     ██████████                  ██          █████████ ████  ██████    ███████       ███               ████████             █████████████████   ████████                █████████           ███████          ████       ██     █████████            ███████████         ███        ██
██     ████                                        █████                     ███        ██                 ██████                  █████████████       ████                  ████              ████              ███               ████████             ████████                      ██
██    ████                                          ████                                                    ████                    ████████████        ██           ████                       ██               ████               ████████     ███    █████                         ██
██   █████                                           ███                                      █              ██                      ██████████                    ███████              ███                      ████                ████████   █████    ███                         ███
██   █████    █            ██                 ██     ███                           █         ███                          ██          ███████                     ██████████            ███                      █████                ███████   █████                               ████
█    █████   ███          ███                ████   █████                         ███        ███                        █████            ███                     ████  ██████           ████                    ███████       ██      ███████   █████                              █████
█     █████   █                     ██      ████   ███████       ██     ███       ██         ██        ███   ██         ████                    ██            █████     █████          █████                   █████████      ██      ███████   ██████                              ████
█      ████                        █████   ████    ████████     ████    ███                           █████ ████                               ████  ███     █████      █████       ████████        ██         █████████      ██      ████████ ███████                               ███
█       ███                       ███████  ████    ████████     █████   ████                         ████████████                              ████  ███      ███       █████      ████████        ████         ███████                ███████████████     ███                        ██
█        ███                      ███████   ███     ██████       █████  ██████                       ████████████                               ██   ██                 █████     █████████    ███████████       █████                  █████████████     █████                       ██
█         ████          ████       ██████    ███     █████    ██   ███  █████████       ███          ████████████    ███                 ██          ██                 █████     ████████    █████████████      ████                       █████████     ██████                ███   ██
█         █████        ███████      █████     ███    ██████  ████        ██  █████      ███          ███████████    █████               ████        ████     ██        ██████     ███████     █████   ████       ████                         ██████      ██████               █████  ██
█         █████       ████████        ██      ███    ████████████              ████     ███             ███████     ██████              █████     ██████████████     █████████    ████        █████   ███        ████                          █████       ████      ███    ████████  ██
██        █████     █████████                 ███   █████████████               ███                      █████       █████             ██████    ████  █████████    ██████████     ██   ████  █████              █████                         █████                ████████████████  ██
██       ███████    ███ ████                  ██   ███████████                                            ███          ██             ███████    ███    ████████    █████████           ███████████               ███████                     █████                █████████████████  ██
██     ██████████        ███                 ██   ███████████                                             ███                        ███████     ███     ███████    ██████              ████████████         █      ██████                   █████               ██████        █████████
██    ███████████        ███          ████  ███    █████████                                              ███               ██     █████         ███        ███                              ████████       ███      █████                  █████               █████           ████████
██   ███████████         ███         ██████████         ████                                              ████                    ███            ████        ██                                  █████     █████     ██████                 ██████  ██          ████             ███████
███████████████          ███      █████████████          ██                                              █████                   ████             ███                                             █████    ██████    ██████            ██    ██████████         ████             ███████
███████████████           ███    ██████  █████                                          █              ████████                  ████              █                      ██                       ████    ███████   ██████         ███████   ████████████       ██             ████████
███████████████           ███    █████                                                 ███            ████████████               █████                                   ███      ██               ████   ████████   ████           ████████     ██████████                     ████████
████████████████    ██   ███      ████                                                 ███             ████████████              █████                            ████   ███     ████               ██    ███████     ██            ████  █       ██  █████                     ████████
██████████ ████████████████        ███                              ██                 ███              ███████████               ███                           ██████    █      ████   ███  ██           ██████                     ██                ███     ████            ███  ████
██████████████████████████         ████                            █████          ███                    ███    ███                             ███            ██████            ███   █████████          █████                                         █     ██████          ███    ███
█████████████████████████    ██     █████                   █      ██████   ██    ███             ██      █      ███                            ███            █████             ███  ███████████         █████                                               ███████         ██     ███
█████    █████████  ████    ████     █████                 ███      █████  ███   ███              ███            ███                ██          ███            █████                  ████████████        ██████ █                 ███                         ███████  ██   ███      ██
████      █████      ██     █████    █████                 █████    ████   ███   ███              ████            ██               ████         ███            █████                  █████████████        ████████             ██████                         ████████████  ███      ██
███                         ██████    ████          ███     █████               ████              ████                            ██████       ███              ████                  ██████████████        ███████            ███████               ██       █████████████  ████     ██
███                         ██████      █           ███      █████              █████              ██                             ███████    █████                                    ███████████████   ██   ██████           ███████               ████   ████████████████   ███     ██
████                         ████                   ████     █████              █████                                             ███████   █████                                     ██████████  █████████     ██           ███████               █████  █████████████████    ███    ██
█████                                        ██     █████   █████               ████                                    ██        ██  ██     █████       ██                            ████████    ████████                 ████                   ████   ████    ████████      ███   ██
█████                                      █████    █████   █████               ██                                     █████                 ████████     █                    ██         ████     ████████                ████                    ███     ██      ██           ███   ██
██████                 █          ██      ███████    ████   █████                              ███                     █████                 ████████                         ████                ███   ████              █████                    ██                          ███    ██
██████                ███    ████████     ███████    ███     ████                             ██████                    ████                 ████████                        ██████████          ████   ████     ███      █████              █    ███                         ████    ██
███████               ████   ████████      ██  ██    ███     ████                            ████████           █                             ██████                        ████████████         ███     ██      ███      ██████            ███    █                          ███     ██
███████      ██       █████ █████████               ████      ██                 ███        █████████                                          ████                        █████████████          █              ██         █████           ███                               ███    ███
███████     ███       ███████████████              █████                        ███████     █████████                                           ██                         ████████████                                      ████            ██                                     ████
██████     ███         █████████████   ██████      █████                ████████████████    ████████                                                                       ███████████                                        ██             ███                       ██          █████
█████    █████          ████████████  ████████      ███               ███████████   ████     ██████               ██   ██████     ███    ██                                 ██████████                                                        ███                      ████        █████
█████   █████            ███████████  █████████                      ███████████     ██                           ███████████     ███    ██████        ████                    ███████                                                        █████████     ██          ████       █████
████   ██████            ██████████    █████████         ███         ███████████                                 ████████████     ████   █████████     ████████                 █████                                                          ████████    ███████       ████     ██████
████   █████             ███████       ████  ████       █████         ███    ██                                  █████████         ████  ███████████  ██████████                                                                                  █████    ████████      ████   ████████
████    ███     ███     ███████         ██    ████      ███████                                                  ████████           █████   ████████████████████                        █                                ██         ███                    █████████    █████  █████████
█████          █████     █████                █████     ████████                       ███           █            ██████             ████    ████████████████████                      ███              ███             █████      █████                   ██   ████████████  ██████████
██████         ██████      ██                 █████     ████████████                  ██████                                         ████    ████████████████████           ███        ███             █████           ███████     █████                  ███      ███████    ██████████
███████       ███████                          █████    ████████████                  ███████                  ██              ██   █████   █████████████████  ██           ████                      ██████        ███████████    ██████                  ██       █████      █████████
███████       ███████                           ████    █████     ██            ██    ███████               █████             ███████████   █████     █████                 ████                      █████        █████████████  ████████                 ██████    ███       █████████
██████        ███████           ██      ██       ███    ████                   ████    ███████           ████████            ████████████   ████       ███                   ███                       ███        ████████████████████████                 ███████             █████████
█████         ███████          ████    ████      ███     ██                   ██████    ███████         ███████            ███████████       ███       ███                    ███                                 ████████████████████████                 ███████             █████████
████           █████           █████   █████    ████                          ██████      ██████        █████             ██████   ██         ███       █       ████████      ███                                 ██████████████████                        ██████             █████████
████                   ██      █████████████   ████               ███         █████        █████       █████              █████                ███       █     ██████████    █████             ██                  ██   ███████████                           █████             ██  ████
███                   █████     ████████████   █████             █████        ████         ████        ████                ████                ███      ███    ██████████    █████           █████                       █████████                               ███                 ███
██                    ██████     ██████████    ███████████       █████         ██           ██          ██                  ████               ███    ██████  ██████  ████  ███████   ████████████                        ████████                                ███                ███
██                    ███████     ███████       ██████████        ████              █                                        ████                    █████████████     ███  ███████   ████████████                           █████████                            ███               ████
██                     ███████      ███          ████████          ███             ████                     ███               ███                    ███████████             █████      ███████████                           █████████                            ██              █████
██                     ███████                   ███████            ██             █████                    ███                ██                    ███████                 ████        ██████████████                       █████ ██                                             █████
██                      █████             ██      █████             ███    ██       ████        █           ███                                      █████                   ███        █████    ███████      ██          ██   ██                                                   ████
██                                       ██████   █████             ████  ████       ███                     █                                        ███                    ███      ██████      ██████     ████        ████                                                        ███
██                                       ███████ ██████             ██████████       ███                               ██                  ██                    █            ██     ███████       ████      ████       █████                             ██                         ███
█                                         ██████████████             ████████        ████                     ██      ████                 ██████               ███           ███     █████         ███       ██        █████                   ████     ███                          ██
█                                         ██████████████             ████████        ████                     ███     ████                 ██████              ████          ████                    ███                 ███                   ██████   ████                          ██
█                   █████                 █████████████             ████████          ███                █    ███     ███         ██  ██  ███████             ████          ████              ███    ████                          ███         ████████████      ██                  ███
█                  ███████  ███           ████████           ██████████████           ███               ███   ███    ████        ██████████████              █████         ████              █████  █████       ████              █████         ███████████      ██    ██         ██████
██                ██████████████       ███████████          ███████████████          █████      ██     █████ █████  ██████      ██████████████     ███    █████████       █████             ██████████████     ███████           ███████████   █████████████    ████  ████       ███████
████████       ███████████████████████████████████     ████████████████████      ███████████████████  █████████████████████████████████████████   █████  ██████████████████████  ███████████████████████████████████████████████████████████████████████████████████████████████████████
████████████████████████████████████████████████████████████████████████████████████████████████████████████████████████████████████████████████████████████████████████████████████████████████████████████████████████████████████████████████████████████████████████████████████████
