████████████████████████████████████████████████████████████████████████████████████████████████████████████████████████████████████████████████████████████████████████████████████████████████████████████████████████████████████████████████████████████████████████████████████████
█   ██ █    ██ █  ███  █ █      ████  █    ██ █  ██ █    ██  █   ██ █  █  ██ █   █      ██ █  █  ██     █  ███  ██ ████  █ █   █   █ ███ █ █  █     ████  ██   █         ██ █ ██ █ ██          █ █   ██    ██      █ ███ ██ ██ ██ █   ███  ███ ██     █████████ █ ██     ██  ███   █████
█ █    ███ █  ██ █    ██ ███ █ ██ █ ██ ██ █████ ██  ██ ████   █ ███ █    █      ██ █  ██  █ █ █  █ ██ █ ██████ █ █    █  ██  █  ███ ███ █ █  ██        ███ ████  ██    ███ █     █ █████ ██ █   █████ █    █ █ █      █   ████ █ █ █  ██ ████  ██ █ █  ██ ██████   ███ █   █ ██  █    ██
█   ██  █ ██  █  █  ███ ███ █    ██ ███ ██  ██ █       █  █ █  █  █ █ █  █   █  █  █ █  █ █ ██████   █ █ ███   ███ █ █      ███  █   █ █  ███    ██  █    █ ██   █      █   █  █ ██  █ ██ ██ █ ██    █  █    ███ ██   ██  █        ████ █ ███    ███████      ██    ████ ████ █ ██   █ █
█   █     ███    █ █  ██ ██ █  ██ █  ███    █ █ █  ██ █ █ ████ █  ███    █ █       ███   ██    █ █  █ ██         █    █  █    ███ █    █  █   █      █  ██ █ █ ██  █  █  ██  ██  █   ████  ███ █    ██ █  █████ █    █  █  █ ██  ████  █  █ █ ███  █ ███ █ █ ██ █  █   ███   █  █ █  ███
█     █ █ █     ███  █   █    ██   █ █ ███ ██    ███ ████  ██  █   ██████ █ █  █   █ █ ██   ██ ██ █ █    ██  █   █   ██ ██  █      █  █ ██     █ ██     █      █ █  ██ ███ █  ██ ██  █   █ ██████  ███  █ █      ██ █ █  █    ██ █ █ █    █    █      ██        █ █ ██    ████       █ █
█  ██ ████   █ ██   █   ██  █ █ █       ██ █ █ ████ ██ █ ████     █    ██     █  █    █ █ █ ██  ███ █     █ ██   ██████  █  ██ ██   █  █   ███████  █   ██     █ █ █ ██ ██      ███  █      ██         ██  █ █████   █  █  ██ ██   ███ █ █    █ ███ █    ██  █  █ █     ██  █ █ █ █ █ ██
█     █   ██      █   █  ██   ███  █ ███  ██     █ ██ ███ █ █  █ ████ █ ███  █  ██ ███       ███ ██ █    █   ████ █    ██    █   █ █ ████   ████████   █  ██ █  ███  ██████ █ █     ██  █  █ █ ██ █   █ █      ██ █ ██  █ █    ██ █     ███      █ ██           ███████      █ ██  █ ███
███ ██  ███   ██ ██    █    █   █ ████   █ █  █ █  ██    █  ██  █   █ █ █ █     ██ █ █ █ █   █ ██  ██     ███ █  ██ ██ ██ ███  ████   █   ██ █  █ █  ████ ███  ████████  █ ████    █   █       ██  █    █ █ █ █ ██████ ██         █ █  █ █ ██       █  █     ███    █ █  ███ ███  █ █ ██
█ █    █  █ █ █  █ █   ██    █  ██ ██   █  ██  ██  █   █     ██      ██   ███ █   █ ██ █  ███   █  █ █  █    ██  ███ ███ █   █ █ ██      █ █ ███ █    ███ ███   ██  █   █   █  ████   █  █    █ █    █  ██ ██  ███      ███ █ ████   ██ █  █  █   ██    █   ███  █ ██ █    █      █  ███
███ █ ██   █ ██  █  █  █ ███  █    ██   █████   ███  ██  █  ██     █ █   ██ ██   █   █ ███ █ █    █ ██ ██  █  █ █ ██     █ █  ██ █ ██    ██    █  ██   ███ ██       █   ████  █ ███ █ ████ █████ ██   ███ ██  █  ██   ███   ██ █ █ █  █   █████ █  ███████  █    ████  █  █████ █     ██
██  ███   █████ █ ██████ █ █  █ █ ██ ███     █ █ █    █ █   █   ██ ██  ████ █  ███ █    █  ████ ███ █  █    ██   █ ██ █  ██     █   █████   █████ █  ███ ██   █  ███   ██    ████  ██████████   █ ██    █  ████████     █  ██████ █   █ ██ █      ██████    ██  ██  █   █  ███ ██ █ ██ █
█   ██ █ █    ██ ███  █ █████  █   ██ ██  █    █ █    █        █    ████   █  █ █    ██  █   ██ ██ ███ █     █ ██ █   ██████ █  █ █   ████  █    ██ █   █  █ █  █   ██ ██ ██ █████  █  ████ █  ███ █ ███   ███ ██ █ █ █    █   █    █ █         █  ██ ██ █ █ ██  █   ██  █ █   █    ████
█  ██ ██████   █ ██ ████ ███    █    █ ██  █  █        ██ █   █ ██   ████ █    ██     █    █  █  ███ █ ████       █         █  ██  ██   ███   █ █ ███  ██ ███ █  █ ██  ██  █   ███ ███ ███   ██ █ ██       ██   █ ████  █    ██     █  █  █ █ ███  █      ███  ██ █   ██       ████ █  █
███   ██  ██████ █ █       ███  █ ██ █████  ██  ██ █  █  █ ██  █        ██ █     █ █ ██  █  ██  ██  ██ ██  ███ █ █   █  █ ██  ██    █ █   █  ██  ███ █    █ ████ █ █ █  ██  ██  █      ███      ███  █    █ █ ██    █  █             █ █  ██  █ ██  █    ██  █     ████    ██ ██ ██    █
█  ███   █ █    ██   █ ██  █     ██ █   ██ ██ █ ██      █ ██     █  ██ █  ████  ██   ██    █  █ ███  ██ █ ██      █ █████    █ █ █  █  █ ███ █ ██ █ ███  █  ██ █ █  █    ████      █   █  █  ██       ████ █ ██ █ █        █ █ █ ███ ██ █  ███  ██ █  █ ██ ██ ██ ███ █ ████ █    █ █  ██
█ █   █    █      █ █  ███      █    █   ██  █  ███    █     ██ ████ ███  ███   ██ █ █    ███ ██ ██ █  ██  █ █ ████   █ █    █   █  ███   ██   █ █  █ █  ██ █ █ █  █ ██ ██   █   ███ ██   ██  █     █ ████   ███ ███      ███   █ █      █ █    ████  █  ███   ██ █ █ ██  █ ██     █   █
███   ██   ████     ████ █  ███ ██    ██ █ █  █  ██ ███  █  ██ ██   █   █   █    ██ ██   █   █  ███    █   ██      ██  █  ██  ██ █ █ █  ██ █ █   █ ████   █  █ █ █   █  ██ ███  █   █  ████   ███     █ ██        █  ███   █       █  ██ ███ █ ██   ██   █ █  ██  ███   █   █    █ ███ █
█  █  █     ████ █ ██ ██ ██ █ █ █    █ █ ██████    █  █   ██ ██   ██ █ █    ██    █  ██      █     ███     █ █  █       ██   ███ ██ █    ██ ██ █      █   █ ███     █  █ ████ ██  █  █   █  ██ ██ █    ██  █ ██ █ █ ██  █ █     █ █ █   ███   █  █ ██ █  ██  █  ██ █  ██  █      ██    █
█████     ███ █ █  █ ██  █████       ██     ██  ██ █ █ ██ ██  ██ ██████████  ██      ██ █    ███    █   ██     █ ████ ██ ███ █  ████ █    ██ ███ █   █   █   █ █   █     ██  ██  ████ ██  ██    █  ███  █  █       █ ███ ██ █  ███ █          ████  █     ██ █ ██ █████ ███  ████ █ ██ █
█     █  ███ █ ██   ██████  ██ █    █   ██ ██  █     ██ ██ █     █ ██ █        █   ██ █ ██  █████ ███ ██ ████ ██   █ ███ █     ██  █ █ ██ █ █   ███   ██  ██  █ ██ █ █     █ █ █   ██ █  ███ █   ██ █   █ ███ █ ██ ███   ██       ██  █     █   █ █    █ ██     ███ █ █    ████        █
███     █   ██ ██ ██  ██ █ ██  ██      ██  █  ██   █  ██████      █ █  ██      █   █   ███ ███ ██          ██ ██   ██        █  ██  ██ █ █ ██  █  █  █ █ █  ███ █   █ █ ██ █ █         ███  ████ █   █  █ █  █ █████  ██   █ ███ █   █████    █        █ █ ███ █ █ ██  ██ ██  ███ ███  █
█     ██    █ █  █  █     █  █ █ ██   █ █   █ █████  █ █   █    █  █  █ ███ █   ███  █   █    █  █ █████     █ ███  ██         █  ███    ██  █    █    █ █ █ ██  ███  █ █    ██████   █████ █ █  █  █   ██  ██ █ █      █ ██     ██     ██  █  ████ █  █ ████  █  █ ███   ██ █  █ ██ █ █
██████   █      █ █   ██   █   █ ██ █ ██  ██ ███  ███ █      █  ███  ██████ ██ █     ██ █ █  █████  █  ███ █ █  █ █     █  ███  █████ ██  █ █  █    ████  █   █  ██  █   █    █ █    ██    █    █ █ █ █   ██  █   █  ██ █ ███ █ █   █  ██ ██ █  ████   ██ █ █  █    █ ███  ██     █    █
█ ██  █  ██    █  ███    █   █ █ █ █    █ █   █  ███  █      █ ███ █ █ █ █    █ ██      ██ ███   ██ █ ███  █          █ █  ██   █     █ █ ███ █    █    █   █ █ █    █████ ████  ███ ██  █      ███ █   █             ██   █    ██   █ ███  ██ ██ █  █ █ █ ██ ██   █  █    █ ██ ██  █  █
█   █ ██  █   █    ██  █████████    █   █     ████    ███ █  █ ████   ██  ██         █ ███    █ ██ █ █  ██ █ ██ █ █   ███     █   █   █ ██    █ ██ █ █    ██    █  █  ██   ██ ██ ███   █   █   █  ██  █   █  ██  ████    ████  █ ███  ███   █ ███  █ █ █  ██  ████  ██ ██      █    ████
███ ██   █   ██ ██       █ █   ██ ██ █ ██   ██ █ ████  ███  █ █ █  ██  ██   ██  ██  ██ █████ █ ██ █ █    ██       █ █   █      █  ██      █ ██ ██ ██    ████ █ ████     ███ ████ █  ███  █ █ █ █ ██  █   ███  █ █ ██   █ ██████  ███ █   █ █████ █   █ █  ██     ██  ███ █    ██ ████  █
█       ███ █ █ █ █ █ █ ███    ██ ███   ████   ██  ██ ██ ███   █ █  █ ██ ████████  █  █ █   ██████ ███   █  ██ ██ █     █     █ █    █ ███   ███████  ██ █         ██ █    █ ██     █  ████  ██████   █  █ █  ██   ██ ███   ████  █  ██  ██  █  █    ██ ███  █ █ █ █    █ █████ ███ █  █
█ █   █ █ ██  ████  ██  █████    ███████  ███     █ █ █ ██ █ █ █  █  █  █  ██    █   ██ █  █    █ █ ████   █    █ ███   ████  █    █ ████      ██ █  █ █ █ ███ █ █   █  █    █████ █  ██  ██ █  █  ██   █ █ █  █    █  █  █  █   █     ██  █       ██    █   ███ ████ ██ ██   ██ █████ █
███   █ ██ █ █   ██ █   ██  █    █    █ █   ██  █   ███   ██ ███ ███   █ ██ ██ █   ███ ██ █ █  █   ██ ███   █ █   █   █ █████  ███  ██ ██  █ ██ █ ██  ██  █ █  ███ █    ████ █         █        █   ██   █ ██ ████ ████  █   ███   █ ████ █ █ █ █████        █  █  ██  █ █ █   ██      █
█     █ █    █ ██ █ ██   █  ███ ██ █ █   █ █ ███    █ █  ██  ███ █████ ████ ██   ███ █████ █   ██ █ █  █ ███ █ █ █ █   ███████ █ ██████ ████ ██  ██     ██ ██  █  █  █ ██  ██   █ ███    ██  █ ███  █ ███ █ █ █  █  ███  █ ██ ███    █ ██   ██  █ ██ █  █   █ █  ███ ██  █ ███ █████ ███
██ ██  █    ██  ██       ██   ███  █  ██   █   ███   █   ███  ███  █   ███  █  █ █  █  █ █          ██ ████ █   █  ███ ██ █     █  █   ██ ██  ██  ██████        █    █   █████ █  ██    ██  ██████████  █ ██ ██ █  █ ███  █ ███  ███   ███ ███ █ ████  █ ██ █ █  █  █ ███  █  ██       █
█ ██   █  █  █  ██  █  █ ████ ██ █  █  █ ██  █    █      ██  █  █ █   ███    █ ██   ███ ██████  ███   ███  █ █   █ █   █    ██    █  ██  █ █  ██ █ ███ ███    ███  ██  █████ ██        █ █ █ █ █ █     █ █     █ █ █  ██  ██ ███    █     █ ██████ ███    █  █  █ ██ █ ██ ██ █ ███ ██  █
███   █   █ ██ █  ███ █     ████  █  ██ █ ██  ██   ██   █  ████ █   ██ ███     █ ██ █   █  █     ███   ██ █      ██ █      █  █  ██      █  █   ██  █ █   ██████ █  █ ████ █  █  █ ██  █ ███ ████ █ ████ ██  ██ █ █ █     █ █  █ ████      ██    ██ ███   █    ██  █ ██ ███    █     ███
█  ██ ████      ████ ██  █      █   ██ █    █ ████    █ █   █   ████   █ █     █  █   █   ███  █   █      ██    ███    ██   █   ███  █  ██ █   ███ █ █ █    █     █ █ █ ████   █   █ █ █ █ █ ███ ██ █████   ███      █████ ██   █████ ██ █ █  █  █ ██ █ █    ██  ███  █ █ ██ █  █     ██
█ ██    ██  █  ██   █ ███   ████   ██  █ █  ██ ██  █ █  ██     ██  ██ ██████    █ ███ █  ██  █  █  █  ██ █ █    █ ███  ██     ███████    ███ █ ██ ██   █  ██  █ █ █  ███ █████  ████ ██         █ ██   █  █ █ █ █  █    ████ █ ████       █ ████     █████   ███  ██    ████   █     █ █
█ █   █   █   ██ ███ █  ██ █   █ █  ██     █    ███ █   ██  ███  ██    ██ █ █  ██ █ ██  ███  █ █  ████ █  █ █   ██ █ ██    █ ██ █    █ █  ██  ███  █   ██   ██  ███ █ █ █  █    ██  █  ███ █ █   ██   ██   ████ █ █   █  █   ███   █  █   █ ██ ████     ██ ████    ██    █████  ████████
██  █ █ █     █  ██   ██ █     ███  █      █ █ █          █  █ ███       █ ██  ██ █   ██ █ ██ ██ ████ █ █ █       ██████ █  █   ██   ███ ███ ███   █ █   █ ██       █  █████  ████  ██████    ██   █ ████  █ █ █  █       ██ █  █     █████ █    █   █  █ █  █ █████ █     █      ███ ██
█ ███ █ ██  █ ██ ██     ██  █ ██      █ ███  █      █ ███  █ ██ █ █ █ █  █████  ██ █ ██ █ █ █ ███       █████   ███ █    █ ███  █ ██  ██████ █   █ ███████████ ██ ████ █ █      █ █   ███   █    █ █      ██ ███ █  █ █ █ █    ████ ██ █ █   █ █ █ ███████ █████ █ █ █   █   ███   █████
██  ██ █  ██  █   ██ █████ ███ ██ █  ██  █     █ █  ██  █  ██    █    █  █ █      ██ ███  █ █       █ ██ █████ █    █  ██  █ ████  █   █ ███   ██    █ █  ████    █  █ █ █ █    █ ██  █   █████ █ ██ █    ████  ████ ██ ███  ███  █    █  █ █ █    ██   ██  ████ ███  █ ██ ██ ██    ████
██  █ █   █ ███ ███ ███ █ ████     █ █   █  █ █   █ █ █ ███ █ █ ██ █   █ █     ███     █ ███      █    █  █ ██ █   ███ █████    ████  █  █        ████   █  █        ██  █ █   █  ███    █   █ █ █   ███   █       █ ███████ █ █  ███   ███ █ ██ █████ █ █ ██    █        ██ ██  █ ██  █
█   ██  █ ██  █ ████  ████  █ █ ███  ██ █  █  █ █  █ ██████ █   ███ █    █     ██ ██  █  ██ █  █ ██  ██  █ ██ ██     █    █ ██  █ ██  ██  █ ███ ███ █ █   █       █ █ ██   ██   █  █    ██  █ █ █  █ ██   █ ██              █    █      █   █ ██ ███ █ █   ██ ██ ████ ██ ██  █   █████ █
█   ████  ██   █  ███  █   █ █  ██ ██ ████ ███ ███ █         ████       █ █  █ █ █   █    █ ██ █  █ ██ █   █   █  █ █ █    █  █   █  ███  █ ███ █ ███ ██   █ ███ ██ █ ██ █    ██ █████ █ █   █   █ █ ██  ██ ████  █ ██████   █ █    █  ██   ██████ ██  █  █ █  ███  █  ██ ██ ███  █    █
█     ██ █    █  █  ██      ████   ██ █ ██████ ██   █  █   ██ █ ██ █    ██    ██      ██████  ██    █    ███  █████   █ ████       ██ ██  █  █  ██ ██  █  █  ███  ██ █  █  ██  █ █ ██    █ ██ ██  █    █    ██ █   ███    █   ██████   ██ █    █      ██ ███  █   █ ██   █ █ ██    ██ ██
█    █ █ █   █  █ █  ███    █   █ █ ████  █   █ █      █ █ █ █ █  █  ████████  ██ ███ █ ██ █   █  █    █  ███   █ █ █ ██████ █   █████ █    █ █ ███ █ ████  ██ ███   ██  ██ ███ ██ █   ███ █  ███        █ █ █ █ ██   █   █  ███  █████ █ █ ██ █ ███ ██  █ █ ████    █  ██ █   ████  █ █
█ █  █ █ █ █  █     █ █  ██      █  ████ ██████     ██ █  █  ██ ██   █ ██   █ ███ ███████  █ ██ ██  ████ █ ██    █      █ █ ██       ██  █  █ ████   █  ███ █     ██     █  █ █ ██ █    ████ ███  ██  ██    █  █  ██ █  ███  ██ ███ ██ ██ █  █  █   ██  █ ██   ██   ███  ███  ██  ███  █
█ █ █  █ █ ███ █  ██ ██ █  ███    █████ ██  █ █  ██ ██ ██ █ ███  █ ██      █     █      ██ █ █  █   █  ██ ██   █  █ █ ██ █ ███ █   ███   ██ █ █  █  ██  ███   ███████  █      █   ███      █    █      █ █████  ████  ██       ████  █  ███ █  █ █ █  ███   ██  █  ██   █   █ █  ███ ███
██  █  ███ █ █     █ ███ ██  █  ██  ███████ █ ██ █   ██  █████ █  █ ██ ██ ███ ██  █ █ ███   ██  █        █  █    █ ██████  ██ █████ ██  █         ███    █       █████ ███   █    █  ███████ ██████ █ ███ █   █     █ █   ██ █ █ █ ████   █ █    ████  █    █   █ ██  █  ██  █  ██   █ █
█ ██      █ ████   █  ████ ██ ██  ██ █ █     ██ █ ████  ███  █████ █   █ █    █  █ ██  █ █   █     ███ █    ███ ██  █ █ ████ █ █     ██ █     ██ █  █   ██  ██ █ ███     █ █ ███ █ █ ██  ███ ██  ███      ███        █  ███  █     █   █ █   █   ██         ██ █   █   ██       ██   █ █
██  █  █ ██   ██   ██   █ ██     ████   ██ █  ██ ██   █ █  ███  █   █ █ █ ████ █  █ █   █        ██ ██   █  ███    ███  ███ ███ █ █   █  █  █   █  █     █    ███  ██ █     ██ █   ██ █ █ ██ ███   ████  ██ █   ███ █████  █    ███ █   ████ █ █ ██   █ █████ █  █ █  █    █  ███    ███
███ █████      █ █ ███ █  ██     █ ██  ██ ███    ██ █    █      █  ██ █ ██████  █    ██ █  █████ █   █████  █    █ ████████  ██   █ █  █ █  ██ ███ ██ ██   ███  ██     █   █ ██ ██  █   ██  █   █   ███ ██   ██    ██  ██████  █   ██     █  ███   █ ██ █   ██ █ ████ ███ ██  █  █  █  █
█  ██ █   █   ███    █  █    ████████ ██         ███  █   █ ███       █ ██     ██ █  █ ██   █ █  ██  ██ ████ ███ ██   █ █    █ ██ ██ ██       ███ ██ █  ██  ███ █     ███ █ ███  █      ██         █   ██    ████   █   ███ ██   █ █ █  ██ █ █    ███████    █ █████████ ██     ██   ███
█ ████ █    █ ███ ██         ██ ███ █ ███  ██    █ ██    █ █   ██  ███████     █    ██      █ ████   █ █  █ █ █   ███ █ ███ ███ ████ ██ █   ███ █ █  █    ██  █ ██  █████ █████ █  ██ ██  █ █ █   ██       █ ██ █     ██  █ █   ██ █ █ █  ██ █      █   █ █  ████  █████     █    ██  ██
█ █   █  ██ ██ █     ████ ██████    ███   █ █     █  ███  █ ███  ██   █  ███  █     █ █  ████  █   █    ██ █       ███     ██ █   █ █████ ██  ██ ██ █    █  █    █  █ █   ███   ███ █    █ ██████ ███ ███ ██ █ █  ██    █ ███  ██ ███ ██   █   ███ █ █   ██    █  ██     ███   █████ █ █
██████ ███   █ ██  █   ██ █        █  █  █████  █  ███  █████ ████ █ ██  ██ █  █   ███████   █   ███  ██   █  █ ████  ███  █ █    ███   █  █  █       █  ███  █ █  █  ██ █ ██ ██ ████  ████      ███  █  █ █ ███  █ █ █    █████████    █ ███ ██  █    █████ ███  ██         ███ ███████
██  █   ██ █   █ █ █ ██ █   ███ █  ███ ███  █  ███  █        ██ ██  ██   █ ███  ███  █  ███     █  █ ██ █ █    ██ █  █  █    █ ████    ██  █        █  █ ██  ██ █ ██  █   ██   █  ███  ███    ██ █ ██      █     █  ██    █ ██     █ ██ ██ █  █  █  █   ███ ███     █   ██  █  █ █ █   █
█ █████  █    ██    █  █  █     ██ ██    ██████  █  ███ ██  █ ████  █  █ ██ ██████   ██   █   █     █ █ █ ██   ████████ █ ██ █  ██  █ █  █ █ █████   █    █ █ ██  █     ██  █ ██   ████  █████ ████ ███ █    █ ██   ██    ███  █ █   ██ ███ ███ ███ █   █  ██  █   █  █ ███   ███   █  █
█ █    ███  █ █ █   ███    █████ ███     █████  █ ███ █  █      ███████ ██  █ █  █  █     █  █       █ ██ ██ ██      ██   ███  █ █ █   ████  ██ ████    █  ██   ██ █    █  ██   █         ██ █ █ ██  █       █     ██ █  ███ █ █  █   █ ██  █ █ ██ ██  █ ██ █ █ ██  █    ███ █ █  ████ █
██ ███ █    ██ █████   █  █ █         █ █ █   █ █ █ ██       ██ █ █       ██     ██   █ ██ ████   ████ █    █ ████     █ █  ████████   █ █   █ █    █     ██  █ █████ █ █  █ ███      █    █  ███  █ █████ █████████ █ ██       ██████   ███ █ █  █ ██   █ ██ ████ █    ██ █ █ ███    ██
█   █ █ ██ █   █    █ █  █ █ █ █    █████ █  █  █   ██  █  ████  █  █        ███    ███   █ ██ ███ ███ ██ ██   ██   █ ███  ██   █  █     █    █    ███  ███ ██ ██  ███ █   ██   █     █  █ ████    █      █  ██ █   ██ █ █  ██  ██   █  ███ █ ████ █ █ █████  ██   █    █  █  ██      ██
█    ██ █         ██████ █       █ █ ██   █ ██  ████ ███  ██  █     ██  █ █ ████  █ █ ██      ██   ██ █ ██  ██   █ █ █ ███ █ █ █ ██  █ ███  ███ █ ██       ██             █       ██    █ █  ████ ████  █   ███ ██ █    █      █ █ █ █ █ █   ███   █   ████    ██  ███   █ ██   █   █ ██
█  █  █     █  ██  █    ██       ██ █ ██  █ ██  █ █████ ████    ██  █ █ ██  █  █            ████ ██  ██  █ ███      ██ █████ ██    █ █ █ ███  ███  █    ██ █  ██  █ █ █ █   ██ █ ██     █  █████   ██ ███  ███ █    ███ █ ██ █ ████ █   █  █ █    █  █      █ █   ██ █     ██     █  █ █
███      █ ██ ███ ██  █ ██     █ ██ █ ██   ██      ███ █   █ █ █ ██  █    ██    █ ███ █ ███  █    ███ █   ██ █ █ █ ██  █ █ █ █  █ ██  █     █   █ ███   █ ██  ████      █ ██ ███  ███  ███    ██   █ ███ █ ████ ██ ████ ██ ███████  █   █ ███    ██ █   ██ ██     █ ██      █ █ ██ █████
█     █ █  ██    █     █  █  █ ███ ██  ██ ████ █  █      █  █  ████ ██   █ ███ █  ███ ██    █       █ █ █  ██  █       ██ █       ██ █  █   █ █ █ ██ ██  ██████   █        █    █ ██ █ █   ███ ██ ████     ██ █    █ ███ ███  ██     █ ██ █ █ █  █████████ ██   █ ██   █ █    █ █  █  ██
████   █   █  █    █  █ ██ ███ ███████  ██ ███ █  █   ███   ██ █ █   █  █  █  █   █ █  █  ████   ██ █████   █    ███   ████      █ █    ██████ ███ █ █ ██     █   █  █  ██ █  ███  █ █       ██    ███ ██ ██ █  ███ ████    █  ██  █  ██  ██  ███ █    ██    ██ █    █ ███ █     █   ███
██ █  ███ ██         ███    █ ██ █ ██    ███ █    █ ███    █  ███ █    █  █   ██      █ ██████  █   ██████        █ ██       ██ █ ███      █ ███████   █████   ██ █     █  ██████   █  █  █      ██ █ ███ █ ███ █  ██ █ █    █ ████████ ███  █ █ █  ██  ██     █  █  █  █  █   ███    ██
█         █ █      ██   ██  █     █      █  █   █  █ █  ████ █   ███  █   █   █        ██  █ █ █   ███  █ ██      █      █ █   ██ █  █ █ ██    ██    ██ ██  ████ █ █  ██     █ ██  ██ █    █ █   █  █  █  ███    ██ ██ █   █ ██  ███  █   █ █ ██ █    █   █  ██████ █  █ █ █  ████     █
████████████████████████████████████████████████████████████████████████████████████████████████████████████████████████████████████████████████████████████████████████████████████████████████████████████████████████████████████████████████████████████████████████████████████████
