██████████████████████ █████████████████████████████████████
██████████████████████  ██████████████████ █████████ ███████
████ ██████████████████  ████████████████   ███████   ██████
███   ██████████████████         ████       ██████    ██████
███   ██████████████████          ██       ███████   ███████
███   ██████████  █████                  ████████   ████████
█████  ████████    ███                █████████     ████████
██████  ███████    ███               ████████       ████████
███████            ███               ███████         ███████
████████                                 ██          ███████
█████████                                            ███████
██████████                                          ████████
████████████                                 ███████████████
█████████████                               ████████████████
█████████████             ██                ████████████████
████████████   ██    █   ████              ████████      ███
███████████    ██   ██████████           ██████          ███
███████████         ███████████         ███              ███
███████████          █████  ███        ███               ███
████████████         ████    ███      ████               ███
████████████         ████    ███     █████               ███
███████████         ██████           ████                 ██
██    ████         ███████            ██                   █
██             ███████████                                 █
██           █████████████                 ███       ███████
██        ███████████████                  ███       ███████
██       █████████                    ██   ███      ████████
███      ████████                    ████  ███     █████████
████     ████████                    █████████    ██████████
█████    ████████     ██             █████████    ██████████
██████   ████████    ████            ████████    ███   █████
██████   █████████   ██████          ████████     █     ████
█████    ███████████████████        ████████             ███
████    ████████████████████       █████████             ███
███     █████   ████████ ████      ██████████           ████
███      ██        ███    ███      ███████████          ████
███                        ██        ██████████        █████
███                                    █████████   █████████
███                                      ████  █████████████
████                                            ███       ██
████                                                       █
████                                                       █
████                                                       █
███                 ███                                    █
                    ███                                    █
                                                          ██
███                            ███          ██           ███
████                          █████        ████  ████    ███
████                         ███████      ███████████    ███
███                           ██████     ████████████     ██
██                               ███    █████████████     ██
██                     ███              ████████████      ██
███                    ███             █████    ████       █
███                     █              ████      ██         
██                                      ██                  
█                                                    ███  ██
█    ███  ███                                        ███████
██  ██████████████    ██████    ███                 ████████
████████████████████████████████████   █████████  ██████████
█████████████████████████████████████ ██████████████████████
