█████████████████ ██████████████████████████████████████████████████████████████████████████████████████████████████████████████████████████████████████████████████████████████████████████████████████████████████████████████████████████████████████████████████████████████████████
███████████████       █████████████████████████████████████████    █████████████████████████  ███████████████████████████████████████████████████████████  ██████     █████████████  █████  ████████████████████████████████████████████████████████████████████████     ███████████████
███      ████          ███████  ███████████████████████████          ████████                  ███████████   █████████   ██████████████████████████████     ████       ████    ███    ███          ████   ███████    ████████  ███████████████████  ████████████           █████████████
██                      █████    ██████████████████ ██████             ████                     ██   ██       ███████     ███████  ███████████████████      ███         ██     ███                  ██     █████      ██████    █████   █████ ███    █████████              ███████ ████
██                               ████████   ██████   █████                                                    ███████     ██████    █████████████████       ███                 ██                  ██     ████        █████    ████     ███          ███████                ██      ███
██                               ███████     ████     ████                                                   ███████      ██████     ██████████████        ████                                    ████    ████                 ███      ████          █████                         ███
██              ██      ███████████████               ████      ██                   ████          ███      ███████       ██████      ████████████         ████                                    ████    ████                ███       ████           ███       ██                 ███
██             ████    ████████████████                ███      ██                  ██████████    ████   █████████         ██████       ███  █████          ██                     ██              ████    ████               █████      ████                     █████████          ███
█              ████    █████████████████                ███     ██                  ███████████   █████ ███████             ███████           ████                                ████             ████     ██               ██████      ████                       █████████       ████
█   ███         ██      ██████     ███████               ████  ███                   ██████████    ███████████                ██████           ███                           ██  ██████            ████                      ███  █     █████       █                ██  █████     █████
█   ████                 ████       ████████             ████████                      ████████     ██████████        ███      █████            ██                          ████████████          ████                       ██        ███████    ████                    █████   ██████
██  ████                 ████        ███████████         ███████                        ██████      ███████████      █████      ███             ███                      ███████████████         ███                                   ██████████████                     ██████████████
███  ███                 █████        █████████████      ███████                         ████       █████████████    ██████      ██             █████              ██   ███     █████           ███                                    ████████████                       ██████████████
███   █                 ██████        ██████   █████    ████████                          ███       ██████████████    █████      ██             ██████            ████████       ████            █                                      █████ ████   ██                  ████████  █████
███              ███    ██████         ███      ████    ███████     ███                    ███     ███████████████       ██      ███            ██████             ██████         ████                                                   ███   ████ ████                ████████      ██
██               ████    ██                      ███    ██████     ██████             ██   ███    ████████████████                ██            ██████                              ███                    ██  ██                        ███   █████████               ████████        █
██               ████                            ███    █████     ████████           ████ █████  ███████  ████                    ███            ██████                              ██                   ████████            ██                   ██████  ███        ███████          █
█                █████            ██                     ████    █████████          ███████████████████    ██                      ███             ███████       █        ███        ██                   ████████            ████                  ██████████       ███████           █
█               ███████          ████                     ███████████████           ███████████████████            ██         ██    ████            ███████     ███      █████      ███                    ██████             █████                 ██████████       ███████           █
█              █████████   ██    ████                      ███████   ██            ████████████████████         ██████       ████    ████              ███       ██      ██████     ████                   █████               █████                ██████████      ███████    █      ██
██             ███████████████  █████                       █████                  ████  █████████████         ███████       ████     ████                        ██      ██████    ████          ██       █████                █████               ██████████      █████     ███    ███
███            █████████████████████           ███           ███                  ████     ████████            ██████       ██████     ████         ██             ███     ███████   ██          ███       █████                 ████                █████  ██       █      █████    ███
█████          █████   ███████████             ████                             ██████      ██████             █████       ███████     ████        ████            ████    ████████               █         ████                                       ██                  ███████  ████
██████         ████      ███                   ████    ████                    ████████      ████              █████       ███████      ███       ██████           █████  ██████████                         ███              █                                           ██████████████
██████         ███                  ██          ██    ██████    ██             █████████     ████        ██    ██████     █████████     ███       ████████          ████████████████                                  ██████████                                           █   █████████
██████         ███                 ████               ██████    ██              █████████     ███       ████    █████     ██████████    ████      █████████          ████████   ███       █                          ███████████                 ██    ██                       ████████
██████         ███                 ███                 ████     ██               ████████     ███       ████     ████    ███████████    ████████ ███████████         ███████     ██      ████                      █████████████                ██████████                       ███████
███████         █                  ███          ███     ██       ██               ██████      ███      █████     █████  ███████████     ████████████████████          █████               ████                █████████████████         ██      ███████████                          ███
████████       █          ██████   ████         ███     ██        █                ███         ██      █████     █████████████████       ███████████████████           ██                 ████               ██████████████████         ██     █████████████                          ██
█████████     ███        ████████ █████████     ███    ████       █████                                 ███     █████████████████           ███████████████                               ████          ██   █████████████████          ██    ██████████████        ███               ██
█████████     ███        ████████ ██████████           █████       ████████                                    █████████████████             ██████████                                    ██          ████   ██    ██████                    ██  ██████████       █████              ██
████████                 ████      █████████          ███████      █████████                                   █████████████████             █████████          ██              ██                    ██████         ████                          █████████       █████               █
███████                  ███        ████████          ███████      █████████                                   ██████████████████            ████████           ██             ████                  ████████        █████                          ████████        ████               █
███████                  ███         ██████           ███████     █████████                                     █████  ██████████            ██████             ██             ████                 ██████████      ██████                          ███████          ██               ██
███████                             ███████           ██████     █████████                                      ████     █████████            █████    ███                    ████                 ███████████████████████                          ███████                           ██
██████                             █████████          ██████    ███  █████                                     █████      █████████           █████████████                   ███         █        ██████████████████████                          █████████                          ██
█████              ███             ████████████      ███████     █    ████                                    ██████            ███            ████████████                    █         ██        ██████████████████                              █████████                   ██    ███
█████          ███████              ████████████    ███████            ███                                    ███████            ██    ███      ███  ██████                               █         █████████   ████                               █████████                  ████   ███
█████   ██    ████████                ██████████    ██████             ███                                     ██████                 █████           ████     ██                                   ████████    ███                                ███████                    ███   ████
█████         ███████                  ████████     ██████            ████                               ███    ████                  ██████           ███    ████                                  ████████    ███                             █████████                      █    ████
████          ██████                  ████████       ██████ ███      █████                       ██     █████    ██                   ██████           ██     █████      ██                         ████████    ███                            ██████████                           ████
████           █████                █████████         █████████     ██████    ██                ████   ██████                         █████            ██     ███████    ████                       ████████    ████                            ██████████   ██           █         ████
███             ████               █████████          █████████    ██  ███    ██                 ███████████               ██          ███                     ███████    ████                      ███████     █████                              ███████  ████         ███        ████
██               ███              █████████           ██████      ██          ██                  █████████               ███                  ███                 ██      █████                    ████       ███████                ██            ██████  ████          ████       ███
██                ███            █████████            █████      ███          ██                   ███████                ███                 ██████                       ██████              ██    ██        ███████               ████           ██████  ████           ████       ██
██      █         ███           █████████             █████     ████         ███                    ██████               █████                ███████                     ██████              ████              ███████              ████           ██████   ███           ████       ██
██     ███       ████          █████  ██              █████     ████        ████                     ████          ███  ██████                    ███                   ██████     ███        ████               ███████              ██           ███████    ██           ████       ██
██     ███       ████         █████                    █████   ████     █████████         ████                    ████████████                                    ██    █████     ████         ██      ██           ████                           ██████                  ████       ██
██     ████      ███         ███                       ████████████    ███████████     ████████                   ████████████                                   ████   ████      ████                ████          ████                           █████                   ███        ██
███     ███                 ███                        ███████████     ███████████    █████████                    ██████████                            ██      ████    ██       █████               ███████       ████                                                   ███       ███
████    ███                 ███                        █████           █████   ██     █████████                     ████████                            ███████   ██              █████                ███████    ███████                                                            ███
████    ████          ██     ██  █           █████      ███            ████            ████████                      ███████                            ███████                    ███                  ██████   ███████████                                                         ███
███     ████         █████      ███        ████████                     ██             █████████                      ██████                             ██████                           ██            █████████████████████     ███                                                 ██
██     ████          ██████     ██      ███████████            ██                      █████████                      ██████                                                             ████           ██████████████████████     █                                                  ██
██    ███             ███████           ████    ███                        ██          █████████   ██                  █████                                                            █████    ███     █████████████████████                                                        ██
██   ███                 █████                                            ████         ████████   ████                  ███           ████                                              █████   ████          █████████████████                                               █       ██
████████                  ████                         ██             █  █████         ███████    ████                               ██████                                     ██       ████   █████          ████████    ████                                              ███      ██
████████                  ████                         ██            ████████      █    █████    ██████                      ██      ███████                                              ██    █████          ███████      ██                   ██                          ███       █
████████    █        ███   ██                                         █████       ████ █████    ███████                      ██       ██████     ███████         ██                             ██████        ████                              ████                                   █
████████   ███       ████                                   █                      ████████    ███████                      ████       █████    ████████████     ███                            ███████  ████████                    ███      ██████                       █          ██
███████     █        ████                                  █████                   ████████    █████                        ████         ██     █████████████    ███         ██                ████  ████████████                  █████████████████                      ███         ██
███                  ███                                    █████                  █████████    ███                          ██                  ██  ████████    ████        ██                 ██    ███████████           ██    █████████████████                       ███         ██
██                   ███                         ███          ██                  ████  ████              ██                                             ████    █████                                   █████████         ████  ███████████  ██                     █                ██
██                   ███                 ████████████                 ███         ███     █              ████                             █               ██      ████                     ██             ████████     █   █████████████████              ███       ███              ███
███                 █████       ██      ██████████████               █████       ████         ███        █████       ██                  ███              ██      █████                   ████           ██████████   ███  █████████████████      ███     ███      █████             ███
█████     ██       ███████     ████    ███████████████        ███  ████████  █████████       █████      ███████     ████           █████████             ████     █████████              █████      █████████████████████████████████████████   ██████   ███████████████            ████
██████   ██████   █████████████████████████████████████  ███████████████████████████████████████████████████████   ██████████████████████████      ███████████   ███████████  ███  ████████████  ████████████████████████████████████████████████████████████████████████     ██████████
████████ ███████████████████████████████████████████████████████████████████████████████████████████████████████████████████████████████████████████████████████████████████████████████████████████████████████████████████████████████████████████████████████████████████████████████
