████████████████████████████████████████████████████████████████████████████████████████████████████████████████████████████████████████████████████████████████████████████████████████████████████████████████████████████████████████████████████████████████████████████████████████
████████████████████   ████████████████████████     ████████████████████████████  ██████████████  ██   █████████████   ████████████    █████████████████████████████████████████████████████████████     ███████████████████████████████████    ████████████████████████████████████████
██████████     ████     ████  ████████████████             ████████████████████    ████████████                 ██      ███  █████         ████████  ███████████████  ██████████████████████████          ██████      █████████   ███████        ███████████████████████       ██    ███
██████████      ███     ███    ███████████████              █████████               ████   ████                               ████          ██████    █████████████    █████████████████  █████            ████            ███     █████         █████           ██████               ██
██████████       ███     █     ███████████████             █████████                        ████                             █████          █████    █████████████      ███████████        ███              ███                    ████           ███             ████                ██
████████████     ████          ████████████████       ██████████████                        █████     ██  ██                 █████          ████    █████████████        █████████                          ███                     ██     ██                      ██                ███
██████  █████   █████          ████████████████     █████████████████                       █████     ███████                █████          ████   ████  ███████        ███   ███                          █████   ████                    ██                  ██       ██         █████
█████    ████   ████          ██████████           ██████████████████                      █████       █████                 █████          ████  ████    ██████       ██                                ███████████████                   ██               ██████     ████     ████████
█████     ██    ██             ████████            ██████   ████  ██          ███          ███          ███                 ███████         ██████████     █████       ██                               ████████████████                                     █████     ████    █████████
█████     ██                       ███             ████      ██              ███                                    █      ██  █████    ██   █████████      ███        █                           █   ████  ████████████  █                                            ██    ██████████
████     ███                                        ██                      ████                                   ███    ███  █████    ███   █████████                                           ████████    ██████████████                                                  ██████████
███      ████                                                               ████                                  █████  ███   █████     ██   ██████████                    █                     ████████     ███████████                       ███                          ████   ███
██       █████                                                             ██████                                 █████████   ██████     ██   ███████████                  ███       ██           ████████      █████████                        ████                        ████     ██
██        █████                                              ████        █████████                                 ████████  ███████     ████████████████                  ███      █████         ███████      █████████                         █████                       ████     ██
██          ███                                 ██          ██████      ███████████                                 ███████  ████████   ███████  ███████        ██                  ██████       █████        █████████                          █████                        ████   ███
███         ██          █                      ████         ███████     █████  █████                      ██        ███████   ███████   ██████     █████       ████                 ██████      ████         ██████████          ██            ███████     ██                  █████████
█████       ██         ███                    ██████████     ██████      ██     █████                     █          ███████   ██████   █████        ██        ████                 ████████   ████          █████████        █████           ███████     ████                  ████████
██████    █████         ███                   ███████████      █████            █████                                 ███████  ██████   █████                   ██                 ████████████████          █████████        ████            ███████    █████                 █████████
███████  ██████         ███                    ██ ████████      ████            █████                                  ██████  █████    ████   ██                                 ██████████████████          ████ ███        ███      ██      █████    ███████                ████  ███
███████████████        ████                        ████████      ██             ████                ███  ██       ██    ████████████     ██   ███                                ████████████   ███████       ███   ██        ██       █        ████   ████████                ███    ██
███   █████           █████                        ████████                     ███                 ███████      ████    ███████████          ███                                ███████████      ██████      ███   ███       ███                ███   ███████                        ██
███   ███             ████          ███           █████████                     ██                   ██████     █████     █████  ███          ██                                 ███████████       █████      ███   ███       ███████             █   ███████                        ███
███    █             ████           ████         ████  ███                      ██                    ████     ██████      ████     ██                     ████                   ███████████       ███      ████   ████      ████████               ████████                        ███
██                   ███            █████        ███              ██            ██                            ████         █████    ███                   █████                    ██████████              █████    ████      █████████  ███         ███  ████                       ███
██                   ███              ██                         ████           ███                           ███          ██████   ████                  ████                     ███████████            █████     █████      █████████████████           ██████                     ██
██                   ████                                 █     █████          █████                          ███         ███████    ██    ██             ███          █   █      ███████ ████             ███      ██████     ████ ████████████           ██████                      █
██                   ████                            ██   ██   ██████         ██████      ██                  ███       ████████          ████            ███         ███  █     ███████   ████                     ██████      █    ███████████          ███████           ██         █
██                  █████                           ████  █    ██████        ███████     ████                  █       ████████          █████             █                     ██████     █████                   █████             █████████           ███████          ████        █
██                 █████                            ████       ███████       ████        ████                          ████████       ███████                                      ████      █████                 ██████             ████████             █████          █████        █
██                 ████                ███  ████     ████       ██████       ████        █████                         █████████     ████████                                       ██        █████                ██████              █████      █          ███         █████         █
██           ██     ███     █         ███████████    ████████     ████       ████         ████████                     █████████     ████████  ███          █████    ███                      █████                ██████       ██      ███      ███          ██       ██████          █
██          ████    ███    ███        ████████████  ██████████     ██         █████        ████████                   █████  ███      ████████████      █████████   █████                     █████               ███████      ████              ████         ███     ███████         ██
██          ████    ████   ███         ███████████████████████     ██           ███         ███████                   █████   █        ██████████      ██████████   ██████                   █████               ███████       █████             ████    ██  ████     ███████        ███
██          █████    ████               ████  ███████████████     ███                        ██████                    ████              ██████      ████████████   ███████                ██████     ██      ██████            ██████          █████   ██████████     ██████        ███
██          █████     ███                      ████████  ███     ████                         █████                     ██                ████       ███████████    ███████               ██████    █████    ███████            ████████        █████   ██████████       █████       ███
██         ██████     ███          ███         ██████    ███  ██████                           █████                                                 █████   ██    ███████                █████    █████     ███████           ██████████        ████   ██████████         ████       ██
██         ██████    ████          ███                    █  ██████                             ████                                                  ███         ███████                  ███     ████      ██████            ██████████         ███    ██████████         ████      ██
█           ███      █████          ███                      █████       ███                     ███                                                             ██████                             ██       ██████            ███████████         ██          ████     ██   ████     ██
█                   ███████         ████████                 ████        ███                                 ██     ███                ███                ████  ██████             ███                       █████              █████████████      ██          █████   ████ █████    ███
██                  ███████        ██████████                 ███       ████                                ████    ███████    ██      ███                ████████████      ███████████                     █████                █████████████              ████████   █████████    ████
████████            ██████         ██████████      ██         ███      ██████                               ████    ████████  ████     ███  ██            ███████████       ██████████                      ████     ██           █████████████            █████████    ██████      ████
████████                    █      █████████      ████       █████     ████████                            █████    ████████   ████        ███████         ███████           █████████                       ███    ████            ██   ██████            █████████    ████         ███
███████                    ███      ████████      ████      ██████     █████████                           ████      ██████     ███        ████████        ██████            ███  █████                       ██   █████                                   █████████     ██          ███
███████                    ██       ████ ██        ███    ███████       ███████         ██████            █████         ██       ███        ██████████      █████           ███    ██████                     ██████████                                   ████████                   ██
████████                            ███            ████  ████           ██████         ██████████         █████                  ███            ███████      ████          ████    ███████                    ██████████                                   ███████    ██              ██
████████                            ████          ██████████           █████        ███████████████       ██████                █████               ████     █████         █████   ███████                    █████████                                     ██████   █████            ██
███████                              ████      █████████████     ██████████        ██████████████████     ████████              ██████               ███    ██████         ██████   ██████                    ████████                                       █████   ██████           ██
███                          █        ████    █████████████     ███████████     ██████████████████████   █████████              ████████              ███  ██████          ███████    ████        ██████     ████████                                         ██████████████          ██
███                         ███        ███     ███  ██████      ██████████      ████████   ███████████████████████               ████████              ██████████         █████████    ███       ███████████████████                                          ██████████████          ██
███                      ██████        ███                       █████          ███████          ████████████████                  ██████                █████████  ███████████████     ████     ████   ████████████     ██████                              ███████████████         ███
███                      ██████        ████                        ██           ██████            ███████████████                   █████                 ████████████████████████      █████     ██     █████  █████   ███████                              ███████████████        ████
████                       ████        ██████                                  ██████             ██████████ ████                   ████                      █████       ██           ██████             ████   ██████████████                               ██       ██████        ███
█████    ███                ████       ██████                                █████                 ████████   ███                  █████                       ███                    ████████            ████    ██████████████                                         █████████    ██
█████   ███████             █████       █████                               █████            ███    ███       ████         ███     █████                                             █████████           ██████       ████████████                                        █████████   ██
█████    ███████           ███████                                          ████            █████            █████        ████     ██████                                            █████████          ███████        ████████████                                       ██████████  ██
████      ████████        █████████                                          ██             █████          ████████  ██   ███       ██████                                           █████████         ███████         ████████████                                      ███████████████
███         ███████       ██████████                                                        █████         ██████████████  ██          ████     ██                           █        ████████         █████             ███████████                                      ███████████████
██           █████        ███████████                                                       █████      ██████    ██████   ██           ███    ████                          ██        ██████          ████               ██████████                                      ██████  ███████
█            ████         ███   ██████                                                       ████     ██████      █████   ██            ██    ████                                    █████          ████                 █████████                                       ████   ███████
█           █████         ███    █████                ███      ███                                    ██████      █████   ██                   ██                  ███               █████        ███████          ██      ████████         ██                 ████             ████████
█           ██████        ████    ████                ███      ███          ██                         ██████      ████   ███                                      ███               ████        ████████      ██████          ████  ███   █████             ██████             ████████
██           ████████      ████    ███                 ██      ███         ███████                         ███     ██████████                                     ███               █████       ████████      ███████           ██   ███   ████████         ███████             ████████
███           ████████      ████    ██    ███                  ███        ████████                          ███     █████████     ██                       █     ███                █████       █████        ███████                ████   █████████        ████                 ███████
████           ███████       ████   ███  █████                  ███      ████████                           ███     ██████████    ██                      ███   ███                 █████        ███         ████       ███        █████    ████████        ██                   ███████
█████   ██      █████        █████████████████                  ████    ██████                     ███      ████    ███████████  ███                 ██   ████ ████                 █████        ███    █████████      █████       █████    ████████                            ████████
██████████████ ██████       ███████████████████                ███████████████    ██          █████████    ██████████████████████████              █████ ███████████     ███       ███████      █████  ██████████     ██████████  ███████   █████████               ███        █████████
██████████████████████ █████████████████████████████   ████████████████████████  █████     ████████████████████████████████████████████████████  ████████████████████████████    ███████████   ███████████████████████████████████████████████████████████   ███████████████████████████
████████████████████████████████████████████████████████████████████████████████████████████████████████████████████████████████████████████████████████████████████████████████████████████████████████████████████████████████████████████████████████████████████████████████████████
