████████████████████████████████████████████████████████████████████████████████████████████████████████████████████████████████████████████████████████████████████████████████████████████████████████████████████████████████████████████████████████████████████████████████████████
███  █████████████████████████    ███████████  █████   ███████████████████████████   ████████  ██████████████████████████████ █████   █████████████████████████████████████████████████████    ███████████████████████  ████████ ███████████████████  █████████████████████████████  ███
██    █████████         █████       ████████                   ████████████████       ██████    ██  █████     ██████████████   ███     ██       ██       █████████████  ██         ████             ███      █████       ██████         ████              ███████████  ████  █████    ██
██    ███                ████        █████                      ████      ████        █████          ███       ████████████    ███                        ███                                                ████           ███                           ██████████          ████    ██
███  ███                  ███                                   ███                   ████                     █████  ████     ███                                                                          ████             ██                           ████████            ████   ███
███████                    █                                    ███                   ███    ██               ██████   ██      ███                                                                         █████                         █████     ██    ███████               ███   ███
██████                                                         ████        █          ██    ████               █ ████                                                            ███   ██                  █████                        ███████   ████  ███████                      ███
█████                                                          ███        ███        ███   █████                  ████                                                          ██████████                 █████                         ██████   ████  ██████                       ███
███                 ██████                                   ██          █████     █████   █████                  █████                                                   ███  ███████████                 █████                                   ███   ████                         ██
██                  ███████     █                           ███          ██████   ███████   ████                  █████                                        ████      █████████   █████           ███    ███                                     █    ████                         ██
██                   █████     ███      ██                  ███          ███████████████     ██                    █████                ███               ██████████     ████████      ██   ███     █████                                                 ███             ██          ██
███                  ████      ███    ████                  ███           ███████████                                ████              █████             ███████████     ████████          ████    ██████                                                          █     ████        ███
████████    ███      ███      ████   █████              ██  ████              ██████                                  ███              ████               █████████       ██████          █████    ██████                         ██                               █     █████     █████
█████████  █████     ███      ████  ███                ████  ███               █████                ██                                 ████                █████                   ██     ████     ██████                   ███   ██                                     ██████   ██████
████████████████    ████       ██   ██                 ████   ███              █████               ████     ███████                    █████               ████                   ████    ███      █████    ████████        ████  ██                 █                    █████   ██████
████████████████   █████            ██                  ████   █               █████              ██████   ████████                     █████             ████                    ████    ███       ████   █████████        ████  ███               ██                     ███    ██████
███████████████    ████             ██                   ████                   █████            ██████████████████                      █████         ███████                     ██     ████       ██    █████████        ███████████              █                             █████
█   ███████████    ██               ██                   ████                   ██████           ██████████████████                 ██    ████        ████████                            ████              ███████         ████████████                                █            ███
█      █████████ ███                ██                   ████                    █████            ██████████   ████                ████    ███        ███████                              ██               ██████          █████████████                      ███     ███           ███
██      ██████████                  ███                   ██                      ████             ████████     ███                ████     █         ██████                                                █████           █████████████       ██           █████      ███          ███
█████  ███████████                  ███                                           ████             ████████      █                 ████                ████                                            ██  █████             █████████ ██      ███         ██████       ███          ███
█████████████████             █                                                   █████            ████████                         ██                            █████              ██                █████████               ██████   ██    ████        █████         ███          ███
███████████████              ███                  ██                ███           ██████           ████████                                                       █████            ████                █████████                ██████ ██████████   █     ███            █           ███
█████████████        ██       █                  ████              █████           █████          ████████            ██                     ████          ██                     ████                 ████████                 ████████████████   ███    ██                         ███
███████  ███         ██                       ███████              █████            ████          █████               ███                   █████         ████                    ███                 ███████                   ███████████        ███    ██      ████               ███
██████    ██                                 ████████               ███             ████          ████                ███                   ████         █████                    ██                  ██████                   ███████████         ████   ██     ██████              ███
██████    ███                               ██████████    ██████                   ████          ████           ██     █            ██      ███   ███    ████                     ██       █           ████               ███████████████          █████████    █████████     ██      ██
██████     ████                            ██████████████████████                  █████         ███           ████                ████    ████   ███    ███                      ██      ███                             ███████████               ████████    █████████████████     ██
█████      ██████                          ██████████████████████                  ███████       ███           █████               ███     ███    ███    ███                                                               █████████                ████████    ████  ██████████      ██
████       ██████                         ███████████████████████                   ███████                     █████                                    ███                                                               ██   ███           ███  █████████     ██     ██           ███
████       ██████                      █████████████████████████                     █████                      █████                                    ███                  █                                           ███   ███          ███████████████                         ███
████       ██████                     ████████████      ███████                       ███                       █████                                     █                  ██                           ██              ███    █            ███████████████                        ███
████   █    █████          ██         ███████████        ██████                                                 █████                   ██                                                               ████             ███                  ███████████████        ██             ███
████  ███   █████         ████         ██████████        █████      ██                                           █████                 ████                                           █                  ████                           ██      ███████████████      ████            ███
████████     ███          ████          █████████       ██████     ████      █                                    ████                █████                                                             █████                          ██████        ██████████      █████            ██
████████                  ███            ███████       ███████     ████     ███                                     █                 █████     ██████                  ██                          █████████                          ████████       ████████        █████           ██
███████                   ███            ██████        ████████    ████      █                                                         ████    ████████      ███       ████                        █████████                            ████████      ██████          █████           ██
██████                   ████            █████          ████████  █████                                                                 ██      ████████     ███        ████    ██                 ████████                                 ████      █████          █████            ██
██████    ███████████   █████    ██      █████    █      █████████████           ██       ██                                                        ████      ██         ████    █           ███  ████████                ██████    ██       ████      ███         ████               ██
██████   █████████████████████   ███     █████    █       ████████████         █████    █████              ██                            █           ███                 █████               ████████████                ██████    ████       ███             ████████               ███
██████   █████████████████████   ██       ████             ██████████         ██████    ████         ██    ██                           ███           ██                 ██████     ████      ███████████            █████████     ████       ████           █████████               ███
██████   ████████  ██████████              ███              █████████         ██████    ██          ████   ███           ██             ███            █                ███████    ██████      ██████████           ██████████    █████        ████          █████████              ████
██████   ███████   █████████                ██              ████████          ███████              ██████  ████         ████             ██   █        ██        █     █████████   ██████      █████████            █████████      ███         ███████       █████                 █████
█████    ████████  ███ ████                 ███             ███████             ██████            ███████   █████       ████                  █        ███      ███   ██████ ████  ███████      ████               ████                         ███████      ████                 ██████
███      ████████████   ███                 ███              ██████              ██████          ███████     █████       ███                           ███      ██    █████   ███   ██████       ██              █████                          ███████       ██                  ██████
██        ██████████     █                 ███               ██████               █████          █████        ████       ████                           ██     ██      ██████████   █████                       ██████                         █████ █                             █████
██         ████████                       ███                ███████               ████    █     ████                     █████                               ███      █████████   ██████                     ████████                         ████                         █       ████
██           █████                        ███         █       ███████               ██     █     ████                 ██   █████                              ████     ████████   ██████                     ██████████               ██       ████                        ███        ██
███           ████                        ███                     ███████                 █      ████        ██    ██████   ████                              ████      ███████  ██████                       ██   ████              ████       ███                        ███         █
███            ████                        ██                      ███████               ███      ████      █████████████    ███                 ███           ██         ████████████                              ██               ████       ███     █████             ████         █
███             ███                        ███                      ██████████          ████       ███       ████████████                       █████                      ██████████                                       ██        ██       ████    ███████            ████         █
███             ████  █████████             ██████                  ███████████         ████       ███        ██████████                        ██████                      ████████   ███                               ██████             ███████   ████████            ███         ██
████      ██    █████ ██████████             █████████              ███████████        ████       ████         ████████                         ██████             ██        ████      ███                              ███████            █████████  ██   ██                         ██
████     ████    ████  █████████             ██████████            ████  ███████      ████       ████           ███████                         ██████         ███████                  █                               ██████             ███████████                                ██
███      ████     ███   ███  ██              ██████████            ███    ██████     ████       █████             █████                         █████        █████████                                            █      ███               ███████████             █                  ██
██        ██            ██                  ██████████                    █████   ██████        ██████             █████                         ████       ██████████                                                                      ██████████            ███                 ██
██                                          █████████                     ████   ██████          ██████             ████        ██                 ██  ██   ████   ██                                                                        ████████            ████                 ██
██                                         ██████████                            █████              ████             ████      ████                  █████   ██                                                                              ██████             ████     ███          ██
██                                        ███████████                             ███                 ██             ████      ████                  ██████                                                                                  █████               ██     █████        ███
██                                    ███████████████                                                                 ███      ████                   █████                               ████                                       █       ████                      ███████      ████
███                                  █████████ ██████                                                                  ██       ██                      ████  ██                         ██████                  ██                 ███     ████                      ████████    ██████
████████                             ████████   ██████                        ███                                                           ██████       ███████                         ██████     ██          ████                 ██      ██                      █████ ████  ███████
████████                              ██████    ███████               ██     █████  ████████       ███          ██                         ████████       ██████                         █████     ████         ████                                                 ████   ████████████
████  ██                               ███       ███████             ████    ████████████████      ███          ██                         █████████      ██████       ██                 ███     ████           ██                                     ██           ███     ███████████
████      ██                           ███       ████████            ████    ████████████████     ████          ███           ██            █████████     ███████     ████                ███    ████                                  █████        ███████           █      ███████████
████     ████    ███      ███████     █████     ███████████          █████  █████████████████    █████          ████         ████████████   █████████     ████████   ██████       ████    ████  █████    ██                       ███████████      ████████                 ████████████
██████  ██████  █████████████████████████████████████████████████   ██████████████████████████  ███████    ██  ██████████   ██████████████  ██████████   ███████████████████     ██████  █████████████  ████  ████████████      ████████████████████████████  ██████  ██████████████████
████████████████████████████████████████████████████████████████████████████████████████████████████████████████████████████████████████████████████████████████████████████████████████████████████████████████████████████████████████████████████████████████████████████████████████
