████████████████████████████████████████████████████████████████████████████████████████████████████████████████████████████████████████████████████████████████████████████████████████████████████████████████████████████████████████████████████████████████████████████████████████
██████████  █████   █████████████████████████████████████████████  ███████████████████████████████████  █████████████████████████████  ████████████████████████████████   ██████  ████████████████████████████████████████████████     █████████████████████████████████████████████████
█████        ███      ███████████████      █████████████████████             ████    ████       ████      ███  █████████████████        █████████       ███    ███████       ██       ██████████  ███████       █████████████████       ████████    ██████████████████            ██████
████                   ██████████           █████   ██████████                                   ██               ██████   ████         █████████                ████                 █████████    █████         ████  ██████████       ████        ████████  ███████               ████
███                      ████████           ████     ████████                                                        ███   ████          █████████                                   ██████████      ██           ██    ██████████ ██   ███         ███████    █████                  ██
██                         ██████           ████      ███████             █                                           ███ ████              ███████                                  █████████                          ██████████████             ███████      ███                    █
█                           ██████           ███         ████            ████                                          ███████               ██████                                  ███████                            ██████████████             ███████              ██     ████    █
█    ██                ██    ██████          ███         ████            ███████                 ██                     ██████                █████                                  ██████                  █           ███     ████         ██   ████████            █████  ██████   █
██  ████              ████   ██████      █  ████         ████             ██████           ██    ███                    ██████                █████                                  ██████                 ███                   ███         █     ████████     ███████████████████   █
██  ███████            ███    ██████    ███████      ███████                ████          ████   █████                  ███████                █████                   ███          ███████                 █████                  ██               █████████   ████████████████████   █
██   ███████                      ███   ██████      ██████                               █████    ███████                ███████                █████                  ███          ███████   ██            █████████              ███               ██  ███████████████████████████  ██
██     █████                       ███  ████        █████               ███              █████         ███                  ██████               ██████  ███           ████  ██     █████████████            █████████            ████                    ███████████  █████    ███   ██
███     ███                        ███  ███          ████               ███       █████   ███           ███████              ██████              ███████████            ███████      ████████████                 ████            ████                     █████████    ███           ██
████    ███                                          █████        ██     ██      ███████                ████████              █████     ██        ██████████             ██████       ███████████                  ███             ██                          ████     ███           ██
████    ███                                           ████       ███              ██████      ███        ███████              ████      ████           ███                            ██████████                               █                                        ███           ██
███     ███                                            ██       ███                 ███      █████         █████               ██        ████                                      ██  █████████           ██                 ███                                      ████            █
███     ███                                                      █                           █████           ██                          █████                                    ████  ████████          ████                ███                           ███       █████            █
███     ███      ██                                                    ██                     ████                                        ████                                    ████   ███████          ████                ███                         ██████      █████           ██
███     ████    ████         ███            ███                        ██                      ██     ███                 ██               ██                                     ████     ██████          ██                 ██     ██                  ███████     █████            ██
████     ██      ██████     ████           █████                       ██                             ████                ███      ██                         █          █         ████     ██████                           ██      ██                  ████████  ███████   ███      ██
████             ██████    █████        ████████                                                     ██████               ████    ███                        ███  ██    ███         ███     ██████                          ███      ██                   ███████████████    ███      ██
████              ████    █████        ██████████                              ██                   ███████                ██████████                        █████████████           ██      █████                 ███      ███                           ███████████████    ████     ██
███                      ████          ████  ████           ████              ████                  ███████                █████████                          ██████████             ███      ████                 ███      ██            █               ████████   ███     ████     ██
███                     ████           ███    ███          ██████████        █████                   ██████               ██████████    ███    █              █████████               ███      ███                 ████                                   ███████             ███     ██
██                     ████       ██  ████    ███          ███████████      █████      █               █████        █████████████████  ████   ███             █████████           ██   ███      ███                ██████                                 ██████              ██     ███
██       ████         ████        ████████     ██     ██   ██████████       ████      ███               █████      ████████████████████████   ███    ██      █████████           ████  ████      ███                ██████                                 ████             ██      ████
██       ██████     ██████        █████████          ████ ██████████        ████       █      ██        █████      ███████████████████████    ███    ███     ████████      ███  ███████████      ████                ████████                                              ███      ████
███       ███████████████          ████████          ██████████████        █████             ████       █████       ████     ████  ██████      █     ███     ███████     ██████████████████      █████               ████████████  █                                        █       ████
███         ████████████            ███████          █████████   ███     ███████          ██████       ██████       ███       ██    ████              ███     ████     ████████████████████     ███████               █   ███████████             ███                               ████
██           ████  █████             ███████         █████████   ██████████████          ██████        █████       ████       ███   ████               ███     ██     █████████████████████    █████████                   ██████████            █████                 █            ████
██            ██     ██              █████████████  ███   █████  ████████                 ███          ███         ████      ████   ███                ████           ████████████  ███████   ██████████                    █████████           █████                 ███           ████
█                                   ███████████████████    ████  ███████          ████                              ███     ████    ███               █████            ██████████      ████  ██████████                     ████████          █████                  ████           ████
█                       ██          ███████████████████     ██   ███████         █████                         ██    ██    █████   ███               █████              ████████        ██   ████  ███                      ███████          ████                    ████           ████
█                      ████         ████████████    ██           ████████         █          ██               ████    ██  █████   ████           █████████                █████              ███                             ██████         ███                       ██             ███
██   ██                ████          ███████                      ████████                  ████              ████    █████████  █████          ████  ███          ███                       ███             ███             ██████        ███                                        ██
████████               ████            ████                          ████████             ██████              ████   █████████   ██████        ████          ██   █████                                     █████            █████         ███                                        ██
████████               ███              ██                           █████████           ███████    █          ████  ███████     █████████      ██           ███  █████                                    ███████            ██                         ███                          ██
████████               ██                                            ████████           ███████    ███          ████  ██████     ██████████                  ██████████                                   ████████     ██                                ████             █████       ██
███████               ███                                            █████               █ ████                 ████   ██████     ██████████                 ██████████                      ██████       ████████     ██                                █████            ██████     ███
█████                ████                        ██                 █████                   ███                █████    ██████    ████  █████                 █████████                     ████████      ████████     ██       ███                       ███             ██████    ████
████                 ████                       ████                █████                    █               ████████  ███████     ██    ████                  ████████                     ████████       ████████           ███████   ██                ██             ███████    ████
████                 ████              ██        ██          █      █████                                    █████████████████           ████          ██      ████████                      ██████        ████████          ██████████████               ██             ███████    ████
████                 ███              ████                  ███     ██████                                       ████████████            ████         ████    ████████               ██       ██          █████████          ██████████████████                          ███████    ████
████                 ███              ████                          ███████                                       ███████████             ██          ███████████████              ████████          ████████ █████          ████  █████████████                 ████    ██████    █████
███                 █████             ████                         ████████                    ██                  ██████████                         ██████████                   █████████        ████████   █████         ███    ███  ██████                ███████   █████    ██████
██                 ███████            ███                         █████████                   ████     ██         ████████                            █████████                    ██ ██████        ████████   █████                ██    ███                  ███████   █████    ██████
██                 ████████          ███                         █████████                    ████    ████      █████████                             ████████                         ████        █████████    ███     ███         ██                         ███████    ████     █████
█                  ████████         ████                        ██████                         ███    ███      █████████                 █           ████████                          ███        ██████████            ████        ███                         ██        ████      ████
█     ██     ███    ██████         █████           ██          ██████                           ██    ██       ████████                 ███         █████████                         ████       ████████████            ████      █████         ██                        ██        ███
█     ███   █████     ████         ████           ████         ██████                           ███  ███       ███████                  ██         ███████████            ███          ██     ███████████████              ███    ███████       ███                                   ██
█     ███    █████     ██           ████         ██████         ██████                         █████████        ███      ██                       ████████████            ███                ██████  ████████               ███   ███████     █████                                   ██
█     ███    █████                  █████        ██  ███         ██████                       ██████████                ████                    █████████████            ████               ██████      █████                ███   ███████  █████                     ██             ███
██    ███    █████                 ███████            ███        ███████                      ███████████                ██                     █████████████      ██    ███                █████        █████    ███        ███      ██████████          █           ███      ███   ███
██    ██     █████             ████████████           ███         ██████                     ███████ █████                         █            █████   ████       ██     █                  ████       ██████   ████        ███       ████████      ███████           █      █████  ███
███  ██       ███              ███████                ███         ██████                    ███████   ████                         ██            ████   █████      ███              █         ███      ████████ █████                  ████████     ████████                  █████  ███
██████                         ██████                 ██          ██████                   ████████   ████                         █              ███████████     ████        ██   ███        ████     ██████████████                 ████████     █████████                   ███   ███
██████   ███                   ████                  ███           ██████                  ████████    ██       ███                                ███████████    ████       ████████         █████     █████████████                ████          ██████████                        ███
█████   █████                  ███                  ████             ████████              ███   ██             █████                              ███████████     ██        █████             ███       ████████████                ███           ███████████                       ███
██      █████                                      █████              ████████                                   █████                      ██      ███    ██               █████                         ███████████                               ███   █████                       ██
█       ████                                       ████               ████████                                   █████                      ██                             ████                             █████████                                      ███                        ██
█         ██                                       ███               ████████            █                       ████                                                     ████                               ████  █        █                                                         ██
██          █       ██                ██                             ██████             ███                       ██                                 ██                   ███                                              ███               ██                              ██       ██
██                 ████              ████                            █████              ███                                                         ████        ██        ███       ██                                     ███              ████                            ████      ██
██                 ████             █████                   █████    █████             ███                  ██                                      █████      ████        ███      ██                                     ███               ███                            ████      ██
██             █████████      ███  ███████        ████     ███████   █████            ████             ██  ████                ██        ██         ██████   ███████       ████    ███           ████         ████        █████              ████                           ████      ██
███           █████████████████████████████  ██████████   █████████████████         ███████       ██████████████    ██        ████      ██████     ██████████████████      ████████████        █████████    █████████    ██████████████     ██████████              ███    █████     ███
████████    ████████████████████████████████████████████████████████████████████   █████████████████████████████████████     ██████   ████████████████████████████████████████████████████   ████████████  ████████████████████████████████████████████    ██████  █████  ██████████████
████████████████████████████████████████████████████████████████████████████████████████████████████████████████████████████████████████████████████████████████████████████████████████████████████████████████████████████████████████████████████████████████████████████████████████
