████████████████████████████████████████████████████████████████████████████████████████ ███████████████████████████████████████████████████████████████████████████████████████████████████████████████████████████████████████████████████████████████████████████████████████████████
████████████████████████████████████  ██████████████████████████  ████████     ████████   ███████████████████   ███████████████   █████████████████████████████████████████████████████████████████ ███████████████████████████  █████      ████████████████████████████████████████████
█████████████   ███████████████████    ████████████████  ██████    ███          ████      ███████████████        █████████████        █████████████████████     █████████████   ███   █████████      ████████████████    ███                    ███████████  ███████  ██████████████████
███      ███     █████████████████     ████████████       █████    ██           ███      ████████████            ████████████            █████████████████       ███████████           ███████      ███████ ████████                             █████████     ████     ████████████████
██                ███████████████       ███████            ████                ███       ███  ██████            ███      █████            ████████████████      █████ █████            ███████    ████████   ███████                             ████████       ██       ██████      ███
██                 ██████████                              ████                ███       ██    ██████           ██        █████            ██████████████      █████   ███            ███████   █████████    ████████                            █████                    ████        ██
██                  ████████                                ██                 ██       ███     █████           ██        ██████   ███      ███████████       █████               ██████████   ████  ███    ████  ███                             ███                     ███         ██
██                   ██████                                                            ████     █████          ███         ██████ █████      █████████        ████               ██████████     ██          ███    ██                          ██████               █     ██         ███
██        ███         ██         ███                                                  ████      ██████         ████          ████ █████       ███████          ██       ███     ██████████                 ████    ██                         ███████              ███               ███
██      ██████                  ████                                ██               ████        ██████        █████             █████       ████████                  █████    ████  ███                   ██    ██                          ███████             ████               ███
██     █████████████      ███  █████                  ██           ███        ██     ████          ████         ████              ██      ███████████                  █████   ████    █                         ███                          ███████   ███     ██████                ██
██    ███████████████    ██████████                  ████        █████       ████     ████          ███          ███              █      ████████████      ██          █████    ██     █                         ███                           ██████    █     ███████                 █
██   █████  █████████    ████████                     ███        ████        █████     █████         ███                                 █████████████    █████        █████          ███             ██          ██                            █████         ████████          ██     █
██   ████    ████████    ███████                       ███                  ██████      █████         ██                                 ██████████████   ██████       ██████         ███            █████        ███                           ██████        ████████          ██     █
██   ███     █████████   ███████                       ████                ████████     ██████                 ███                      ███████████████   ██████       ███████        ███            ██████      ████        ██                  ██████      █████████          ███    █
███  ███      ████████    ███████                     ██████              ██████████    ██████████            █████                 ██████████████████     ████         ██████       █████            ████████   ████       ████                  ██████     █████████          ███    █
███   ██      ███████         ████  ███   ██     ███████████             ███████████     ██████████           █████                ████████  █████████      ██   ███     █████       █████             ████████   ██        █████                  █████     █████████                ██
███   ███      ██              ██████████████   ███████████             ███████████           █████           ████                 ███████                       ████    █████       █████             ████████             ██████          ██      █████   ██████████                ██
██   █████                     ████████████████████████████            ███████████               █           █████     ██          ██████                        ███      ███        ████               ██████             ███████          ██████   █████████████████               ███
██   ████████         █████    ███     ███████████████████            ████████                               ████     ████          ██████                                            ██         ███      ████             ████████   ██    ██████    █████████████████             ████
██   █████████       ███████            █████████    ███              ███  ██                                ████    █████          █████████                                                    ███       ███             █████████████    ██████     ██████████████████           ████
██    ██  ████      ████████                          ██              ██                                      ██     █████         ███████████                                                   ███       ████             ████████████     ██████    █████    ██████████          ████
██          ███     ████████                          ██             ███                                              █████     ██████████████                ███                                           ███               █████████         ████    ███      ██████████         ████
██           ███     ███████                         ███             ███                                               █████   ██████████████                █████                 ██                       ███                ███               ████    █        ██████████  ██    ████
███          ███       ████       ██         ██      ███                                                               █████████████████████             ██  █████                                    ██   ████                                   ████             ███████████████  ████
███                     ███      ███████████████                                                   ██   ██              ████████████████               ████   █████                                  ██████████                                    ███             ████████████████  ███
███                      ██       ██████████████                                                  ████████              ███████████████               █████   ██████████                   ███       ███████████                            ██     ████             ██████████████    ██
███               ██     ██          ███████████                                      ███████    ████████           █    ███      █████               █████   ███████████                 ███████     ████  █████████                      ████     ███             █████████████     ██
███              ███    ███           ██████████                                     █████████   ███████           ███   ██        █████               ████    ███████████             ███████████            ████████     █               ████     ███             ████████████     ███
███             ████   █████          ██████████                                   ████████████  ██████            ███   ██        ██████               ██            █████           █████   ████             ████████   ███               ███    ███              ███████████     ████
███        ██  ████   ███████         █████████                                 ████████ ███████  ████             ███   ██         █████                               ██     ███   █████    ███               ███████   ████               ██    ███              ██████████     █████
████      █████████   ███████         ████████    ███                          ████████   ███████  ██             ████              ████                                      ███████████     ███                 █████   ██████                           ██████   ██████████     █████
█████     ████████    ████████         ███████    ███                          ███████    ███████                █████              ███    ██                                ███████████      ███                 ████   ████████                          ███████   █████████     █████
█████      ███████    ████████          ███████  ████                         █████       ███████                ██████             ███   ████                               ███████████                          ███    ████  ███                          ██████    ████████     █████
█████       █████      ████████         ████████████                     █████████          █████                ██████         █         █████                      ██      ███████████                ██  ██   ████    ███    ██                           █████    █████████    █████
████         ████       ███████   ██    ████████████           ███       █████████           ████                █████         ███        █████                      ██       ██   █████                ███████  █████  ████    ███                           ███     ██████████    ████
███          █████      ███████  ████    ███████████   ███     ████      █████████            ███                ████           ██         ████                     ██              ███                 ███████   ██████████    ███                            ██    ████████████   ████
██           █████      ███████  ████     █████████    ███     █████          ███              ███               ███           ███          ███                 ██████                      █            ██████   █████████     ███                            ███  █████████████    ███
█            █████      ███████  ████      ████████    ███      █████                           ████             ███       ███████                             ██████                      ███            █████   ███████      ████                           ███████████   █████   ████
█            ████        ██████   ████         ████    ███       █████                           ████             █       ████████                            ██████                        █              ███                ████         ██                 ██████████     ████   ████
█             ██          █████    ███          ████    ██       █████     ██                    ████                     ████████                            █████     ███    ██                                            █████        ████               ██████████      ████    ███
█                          ███      █            ███    ██       ████     ████   ████             ██                      ███████                              ██       ███    ███                                          ██████         ████              █████████       ████     ██
██                                               ████  ███       ███      ███████████                                      █████      ██                                 █     ████                                          ████          ████               ████████        ██      ██
██    ██                         ███              █████████     ████       ██████████                      ███              ███      ████                                       ████                                                       ████                ██████                 ██
██   ████                       █████     ██████   ██████████████████       ████████                       ███    █                 █████                ██         ██          ████          ██                                           ████                █████      ██          ██
██   ████                       █████    ████████   ██████████████████          ████                        █    ███                █████   ██           ███       ████         ████         ███                ████                ███    ███                 ████      ████        ███
██    ██                        ████     ████████    ██   ██████   ███           ███                   █          █                  ████  ████          ██         ██          ████        ███                ██████     ██        ███     █                  ███       ████        ███
██    ██                       █████     ████████           ███                  ███                                                 ███   ████                                  ████        █                 ███████  █████       ████                      ███         ██         ███
██                            ██████     ████████                                 ███                                                ███   ████                                  ████                          ██████████████       █████                     ██                      ██
██                ███        ██████       ██████                ███                 ██                                               ██    █████                                 ████                         ██████████████         ████             ██                              ██
██               █████       ██                                ██████                ██                                                   ███████        ██                       ██           █              ██████████████          ██         ██  ███                       ██    ███
██               ██████                                █████  ████████                      █                                            █████████      ███                             ██    ██              ████     █████                    █████████                     ████  ████
██                █████                               ████████████████                     ███                            █████          ██████████     ███     ██                     ████    █              ███         ██                    █████████                     ██████████
███                ████             ███               ████████████████        █            ███                           ██████          ████ █████     ██     ████                    ████          ██        ██                                █████████                    ██████████
████                ███             ███                ███████████████       ███           ███   ███                      ████          ████   ████            ████                     ████         ██        ███                          ██    ██████████                 ████  █████
█████    ███               ███                               ██████████     ████          ███    ███████                  ███       ███████    ███             ███                ██    ████         ██        ███                          ██     ███████████                █     ████
█████    ████              ███                                ██████████   █████         ███     ████████                 ███      █████                                         ████    ████       ████      ████                  █       ██      ███████████                     ████
█████    █████             ███           █                   ███████████████████          █     █████████                 ███      ████                                         ██████   ████      █████     ████     ██           ██                 █████  ██                      ███
█████    ██████           ████          ███                  ████████  █████████              ███████████                  █       ████                                        ████████   ██      ██████     ███     ████           █                  ███                           ███
████      ███████        █████           ███       ███      ████████    ███████              █████████████                          ███                        ███      █      █████████          ██████             █████                                               ███         ███
███          █████    ████████            ███     █████      █████                         █████    ████████                                                  █████            █████████           ████              █████                 ████                         ██████       ███
███           ████   █████████             ███   ██████                                   █████      ████████████                            █              ████████             ██████                              █████                ██████                        ███████      ███
███           ████   █████████     ████     █    █████                           ██        ███        ███████████            ███            ███            █████████              █████     ████                      █████               ██████        ███              ███████     ███
████          ████   ██████████   ██████         █████   ██                      ██                     ██████████  █████████████          ███             ████████                █████  ███████    █                 ██████             ██████       █████              ███████    ███
█████         █████   ███████████████████       ██████  ████         ███         ██                     █████████████████████████       ██████     ██      ████████               ████████████████  ███                 ██████            ███████      █████               ███████  ████
██████   ██  ███████ █████████████████████     █████████████████   ██████       ████     ███           ██████████████████████████      ████████   ████    ██████████     ████    ███████████████████████   ███          ███████    ████  ██████████   ███████             ██████████████
████████████████████████████████████████████  █████████████████████████████   ███████████████      ███████████████████████████████    ███████████████████████████████████████████████████████████████████ █████████████████████████████████████████████████████    █████████████████████
████████████████████████████████████████████████████████████████████████████ ███████████████████████████████████████████████████████████████████████████████████████████████████████████████████████████████████████████████████████████████████████████████████████████████████████████
