██████████████████████████████████████████████████████████████████████████████████████████████████████████████████████████████████████████████████████
█    █   █ █       █  █       ████     ██            ██   █  █   █ █  ███     █      █  ███    ██  █  █ █                          █ █    █  █   █  ██
█  █      ██    █               █  █           ██         █    █  █   █  █    ██  █           ██ █     █  █     █ ██        █            ██          █
█    █   █ ██       █  █     ██ █           ██ █  █   █       █ █  █  █  ██    █         █   ███   █  █ █   ██   █   █  █  ██ █    █     █  █   █   ██
█   █ ██            █  ██  █  ███     █     █    █    █  █ █ ███  ██   █ █     █  █    █   █   █            ██       █  █ █   █ █          ████    █ █
█  █  █     █     ██ ███    ██       █  █   █ ██        █ █  ███     █  █ █   █         ███   █   █ ██    ██   █    █          █ █      ██ █      █ ██
█   █   █  ██  █      █         ████    █           ██  ███ ██     █  █  █          ██                 █ █     █                  █  █ █ █  █       ██
█    █   █   ██   █      █   █             █    ██ ██                   ██   █ ██  ██  █         █        ██       ██  █            █     ██         █
█              █ █   █  █ █      █  █  ███     █    █          █         █         █       █   █  █ █          █    █    █  ██  ██     █        █    █
██████████████████████████████████████████████████████████████████████████████████████████████████████████████████████████████████████████████████████
