████████████████████████████████████████████████████████████████████████████████████████████████████████████████████████████████████████████████████████████████████████████████████████████████████████████████████████████████████████████████████████████████████████████████████████
█  ███   ██  █      █  █    ███ ███ █  ███   ██ █ █       █ ██         █ █ █ ██ ████ █    █     █  ██ █ ███ ██ ██ ███  ██  ███  █   █   ██ ██     ████ █    ██ █      ███ ██     █   █  █ █  █  ██  ██  █ █     ██ ████  ████  █ ████ █ █ ██  ██ ██ █ █ ███ █████       █  ██ █  ███ █ █
████ █  ████  █        ██ ███ █  █    █████ ███ █   █ █████  █     ██ ███ █ █  █  █   ███  █  ███ █  ███  █ █ █ █  █   ██ █████ █  █ ██    █ █    █ █ ██   ██ █  █     ████ ██   ██   █ █    █    █  ██    ██ █ █    ██ ██  ████   █████ █ █ ███  █ █ █ ███   ██ ██ █     █  ███ ███   █
█     █  █ ██ █ ██  █ ███████     █ ██ █   █  █  ███ ███ █  █  ██  █  █ ███ █       ██      █   ██   █  ██    ██ █  ██    ██  ███  ████   ███ █ ██  ██    █   █  █     █       ███   █ ██     ██  ██ █ █  ██ ███ █    █████     ████   █ █    ███     ██ █ ███      ██ █  █ ██ █ ██  █ █
█ █       █ █    █ █  █     █  ████  █ ███ ████ ███  █   █  ██   ██ █ █ █   █ ██  █ ██    █  █ ███   ██        █ ████ █   ██████ █  █ █ █ ████ █████  █ ██ █ ██ █  ██   ██      █  ██ ██  █ ██ █  █  █ █ █  ███        █  ██ █  █ █ █    ████   ██ █ ██ █   █    █  █ ███   ███    █ █ █
█  ████  █     █  █          ██   ██ ██  █   ██ ██  ████ ███ ███  ██  ██ ██ ██ █ █ █   ██      ███ █ █  █    ███ ████  ███ █ █  █ █ ██ █ ██ █ ██ █  ██  █  ████   █  █ ██ ██  █ ██      █ ████     ██ █   ██  █  █ ████ ██ █   ██ █    █  ██     █  █  ██████ ██   █    █    ██   ██ █ █
██   █  ██   ██ ███    █████ █ █   █ █   █    █    █   █ █     ██ █             ██  █  ██ █ █      ████  █ █ ██████     █  █ █ █      ███ █ █ ███  █ ██ █ ████   █   █ █    ██ ███ ██    █   ██  █ ███ ███ █  ██    █  █  ███    █ █ █  █ ████ █ █ █  █  █ █  █  ███  ██     █  █  █ █ █
█ █   ██ █ ██ █  ██   ██ ██ ██ ██████ ██ ██  █    █    ██       ██   █ ██  █ ██ ██ ██████ █ ██  █ █ ███ ███ ██  █      ██ ██████   █  █  ██ █  ██      ██ █  ███      ███   █  █   █  █ ██  █      ███  █  █████    █ █     █████  ██ █ █████  ███ █    █    █ ███ █ █ █ ██    ██    █ █
█  ████       █████ █ █████ ████ ██████   █  ██████ ███ ██████  █  ██ ██  ██  ██   █  █  ██ ████████    ███████  █ █  █   █  █  ███ ██  █ █  ██ █ █ █ █ █  █  ██ ██ ██ █          ███ █  █      ██  ███ █  ███   █ ██  █ █    ███ ███     ██        ███    █ ██  ██ ███ ██████      █  █
█    █         █ █  █    █ ██  █   ██ █ ██ █ █ █      █   █ █   ███ █ █   ██    ██  ██  ██  ██       ██     █   █  █  ███    █ ████ █  ██  █    ███   █ █     ███ █   ██  █  ██  ███ ██  █  ██    █  ██     █   █ █          ██   ██  █ █ ███ █ █ █ ██ ████ █   █   ██ █   █ ██   ██ ███
██ ██ ███  █    ██ ██  █ ███   █    █ █ ███       █      ████ ██  █     █ █ ██    █ █ █ ██ █ ███ ████ █████ █   █    █  █  █ █ █████ █   █  █ █ ██   █ █  ███      █    █   ██████ █ ███      █  █ █ ██     ██    ██     █ ███  █ ███ ██████  █ █  ██  █  █      █     █  ████   ███ ███
█   ███ ██ █ █ █    ██  █ █  █  █   ██  ███ ████   ████ ███ █ ███ █     █    ██ ██   ██  ███ █  █ █  ██████ █ █  █ ██ █  ███     ██ █ █ █  █    █    █ █     █   █ █ █ █ ████  ██ █   █ ████ █ █ ████  ██    █  █  █ █  ██   ██       ██  ███ █ ███   ████ █ ██ █  ██ ██ ██ █ ██ █ ███ █
█ ██ █ █        █ █ █      █ ██ █     ████ ██ ██████     █ ██ █ █ █    ██    ██     █   █████    █ █ █  ██  ██  ██ ████████  ██ ██     █   █   █ ██ ██   █  ███    ███  ██  █    ██ █  █ ████ █  █       ██ █  ████  █ █████  ██    ██ ██████  ███ ███    ██   █  █ █ █  █  ██ █ ████ ██
██ █  █ █      ██   █  █ █████     █ ███ █  █  █ ████    ██  ███    ███   ██ ██  █       █  ██ █      ███ ███ ████    █  █  █    ██  ███   █    █ ███ ██   █ ███  ███  █ ██  █   █ ██  █      ████ █    █      ██ █        ██ █   █ █   █ ████ █     ██  █ ███    █   █   ███ ██    █ ██
██  █ █ ████  ███ ██   ████ ███ ███     ███   █      █ ██████ ██    █ █  █    █  ██    ██   █      ██ ██  ███ █   █ ██   ████    █ █    █  █ ██ ██  ██   █     █ ██ █ ███        ██ █ ██    ██   ███      █  █  █   █ █ █        ████ █    ██  ██ █ █ ██ █    █   █ ███ █  ███████  ██ █
█ ███   ██  ██  ██ ██ █ █ █  ███  █  ███  ██    ████  █ ██ ██      █ ██ █   █    ██   ██   ██ █  ████████ ██  █ ███   █    ███  █ ███    ██    ████ ██    █  █  ██  ██ █ █ █  ██ ██ ████ █  ██ █ ███ █ ███████   ██    █ █████  █  ██   ███   █  ██ ██  █  █ █ █  █    ████ ██ █       █
█  █      █   █   ███ █ ██ █     ███  █      ██ ██ ██ █   ██ ███ █ ███ █████   █   ███ █ █ ██ █ █  ██ █   ███ █ ██ ██   ██ █       █     █ ██ █   ██ █ █ ██    █           █            █ █  █        ██    █  ██ ██ ██   █  ██ █  █   █ ██  ████ █  ████ █████ ██  ████  █  █         █
█  █  ██ ██ █   ██  █     █  █  █   ██    ███ █   ██    ███ █  █ ███ ██  █ ██ █  █  ██ ███  █ █  █   ██    ███    █   █       █  ██ ███ ███  ██ █   ████   █  █ ██      ██ ███ ████ ██ █   █   █    █    ██ █████   ██ ███ ████ ██     █  ███   ██ ██  █ █  ██        ██  ██  █ █ ███  █
█ █  █   █  █  █ █ ██   █    █   █████   ███   █ █  █     █ █   █   ████     █   █  ██████ █ ██ ████ █     █  ██    ██  █ █ █ ███  ██  █      █   █ █ ██████  ██ ████ █ █████ █    ██ █ █     ███ █     █  ██  █ ███     █    ██ ███     █  █        ███  █ █      █ █ █ ████  ████    █
█          ████  █ ████ ██ ███  ███   █ █  █   █  █████ █  ██ ███ █  █  █  █ █  █ █ █   █  █  ███ ██ ██    █   ███████       ███ █   ███  █ █    █ ██   █ ████ █ ██  █ █ █ █ █ ██  ███ ██  ███ █ █ ████ █   █  █   █           ████  ██ ██    █     ██ █ █████ █   █ ██ ██     ██    █ █
█ █   █ █  █    ███████ █ ██  █  ████  █ █   █   █    █ ███ ██ ██ ██  █████ ██    █ ██   ███ █ █████ █ ████  █ ████ ██  █   ███ █      ███ █ █  ██   █  ██  █  █ ██      ██ ██  █   ███   █ ████  █████    ██ █    █     ██   █    █ █   ███  ██    ██████  █ ██ ██ ██ █ █   █ █ █ █ ███
█  ██  █  █ ███████  █ ████  ██  █  ██ █   █   ███   █ █     ███   █     █   ██  █ █████ █ ██ ██ █ █ ██ ██  █   ██ █  ███  █  ██ ██  █  ██  █ ██ █ ███        █    ████  █ ███ █ ██  ███  █ █    ███    █ █ ███ █ █ ███ ██ ████ █ ████    █  █ █ █  █ ██ ██  ██  █ ██  █ █ █ ██ █  ██  █
███  ██  █ █   █ █ █  ██  ████████  █  ███  █ █ ██ █      █  ██  ██ ███     █  █ ████        ███  █           ███ █  ██  █ ████ ███    ████    ███  █ █      ██ █  ████      ██ ██ █   █  █ █  ████  █  █   ██ ███    ██   █  █ █  ██   █ █ █ █       ██ █   ██ █    █ █  ██ █ █ █   ███
█ █ ███ █ ██  █ ██ █ █   ███    █    █  ██   ███ ██    █████    ██ █      ██ █ ██ █  ███ █  █ ███ █ █ █  ██    ██  █ █      ██  █     █  ██      ██ █ █████ █  █  ███  █ █ █ ███████  █  █ ██   █ █  █  █  █   █  ██  ██    █ █  ██ █ ██  █ █   ██ ██   █     █   ███  █  ███ █████   ██
███ █ █   ███ █  █  █ █ █      █   █████      █  █  ██████ ██  █ █ █    ████ █████ ██     █ █  █ █ ██ █ █████   █████  █ █████  ███ ███ █  █         █ █     █    █ █ ███ ██  █ ████    ██   █     ██  █   ██ █ ██ █  ██  ██   ██   █ █   █  █ █  ███  █        █ █    █   █   █ █████ █
█  █ █   ██    ███  █   ██   ███    █   ██     █ █ █   █  ██    ██  ██   █ █   █ ██ █ █████  █ █   ███   ███  █████  █    ██  ██████   █ ██ █ █ █████ ██ ███  █  █    ██ ██ ██ ██ █ █ ████  ██  ██ ██  █ █ ██  █  █   ██ ███ ███ █   █     █ ███ █     ██ ████ █  ██    ███   █ █ ███  █
██ ██  █ █    █ ██ █    █  █    █ █████  ██  █   ██  ███ █  █  ███    ██    █     ██ █ ██  ███ ██   █   ███  █     ███  █  █  ███ ███  ██   █ █    ██  ██ ██    █ ██████  ██  █     █  █  ███  █  █        █   █   ██ █ ██ ██ █  ███   ████     ███  ███ █     █  ██ █ █ █ █ ██   ██ █ █
█  ████ ██     █ █  ███  █   █ █  ███  █  █  █ █ ███ █   ██ █ █  █   █  ███ ████ ██ ██  ██     ██  ██  ██ ██   █ █ ██   ███ █ ███      █ ███████ ██ ███  ██████   █    ██  █    ████     █ █ █ ██ ██ █  █    ██ ██ ███ ████ █ █   ██  ██  ██  █ █ ███ ██ ███  ██  █    █  █ █   ███   ██
██  ██         █       ███ ███ █ █  █   █ █   █ ██  █  ██ █    █████  █ █ █   ██    ██ █  █  ██ █     █ █ █ █  █ ██  █████████ █ ███   █ ███  ████    ███      █ ████ █ ██ █ █  █ ███   █ ████  █ █ ██    █ █ ███ ████ █ ██ ████  █ ███  ██   █   █████  █  ███    ██      █ ██ █     ██
██ █ ██████    ██   ██   █ █████ █  █ ██  ███   ███ ██ ██   █      █ █  █ ██   █ ██ ██  █       ██ ███ █ ██ ██ █  ████  ██ ██ █  █  ██ ██   ██████ ███  ███ ██   █     █  ██ ██    █ █     ██ ███       ████ ███  ██ ██   ████   █    █ ███  ███ ██   ███ █ █    █   ███     █  █  █ ███
█ █  █  █  ████████ ███  ██   █ ██ ███ ███  █  █ █    █  ████     ██████   ██   █   █  █ █  █ ██ █    ██ ██  █ █  ██  █ █  ████  ██ █     █  █ █    ████   █ █    ██    █ █   █   █     █████      ██ ████   █ ██ █    ██  █   ████ ██  ██ █ ██ █ ██ █ █ ███    █ ██████ █ ██  █   █   █
██ █ ██  ██  ███     █  ██ █   █   █ ██  ███ █  ██ █ ██ ███ ███ █ █  ██ █ ██     █ █     █   █ █ ██ █ █      ██████ ████  █ █ ██       █ █    █  ███    ███ █ ███ █   █   █ █ ████   █ █   █  █   █   █ ██  ██  █  █ ███       █ █  █     █ ██ █   ██ █  ███  ██   ██ █    █ █ █   ███ █
█  █ █ █ ██     █ █ █   █ ██ █  ███ █  █████  █ █     █  █████     ████  ███ █  █ █ █ ███  █ █   █           █ ██ ██  ███ ██  █ █  ████  █████████  ██   █     █████ ████ █   █ ████   █   ██    █   ███ █ █     █  █  █ █ ██ █    ██ █  █    █  █ █  █ ████    █     ███ █  █  ██     █
█   ███       █   ███     ██ █   █ █    █  ██   █ ██ ███ ██     █ ██ █  ███     █  ███      █     █  ████  █      █  █ ██ ███ ███ █ █  █ ██  ████  ██ ████    █ ██ █  █   █        █████  █  ███ ██████  █████  ██  ██ ███       ██    ███     █   █ ██  ███  ██   ███ █ ███  ██   █   █
█ ███████  ████   █ █ █ ██ █ █  █   █████  █  ██  ██  ██  ██     ███  ████  █  █         █     ███    ██   █    ██ ██    █ █ ██ ██       ██   █    █    █ ██   ██  ██ ███   █ █████  █     █       █  ██ ████ █ █  █ ██ ██ █ ███   █ ██  █████    █ █ █ █    ██  █ █   █ ██ █   █   ████
██ █ █         █   ██  █  █ █     ██ ██ █  █  █  █    ███████   █ ██  ███ █   █     █   █   █   █ █ █████  █ █ █ ██  █   █ █ █  █ ██      █  ████ ██  ██  █ ██  █   █ █ █     ███     █ █████    ███  █ ██ █ ██████ █  █ ██ █ ███ █     ███    ███ ███ ██ █ █   █ ██         █  ██    ██
██ █  █  █  █  ██  ███  █ █   █  ██ ███ ███ █ █ ██ █ ████ ██   ███   ███ ██  ██  ██   █ ██ ███    ██         ███ ███  █  █ █  █ █ █   ██        ███ ██ ███   █       █  █  █ ██     █   ███  █  ██  █████  ██  █  ███ █ █     █  █  █ █      █  █  ██ ██  █████    █ ██      █  ███  ███
█ ██  ██ ███  ██ █ █ █ ██  █████  █ ██ ██ ██ ██ █  █ ████ █     █ █  █  ██    ██ ████  ███ █            ██  █ ████  ██   █ ██  █ ██ █  ██ ██ █ █ █ ██ ██ ████ █ █████  █   ███ ██     █ ██ ██    ███  ██ █ █     ██  ██   ███  █   █ ██  ███ █ █  ██ ██████ █  █              ████ █ █ █
█ ████  ███ █ ██ █  ██ █ █   █     ██  █ █ ███ █ █ ██ ███ ██  █ ██   █ █ █         █        █ █ █  █ █ ██ █    ███ ██ ███ █   ███ ██ ██████ ██   █    █ █   █  ██      ██               █     ██    █████ ███ █ ███ █   ███  ███      █    █   █     ██ █     █  █ █ █ ███ █  ██    ████
█ █ █ ██ █ █   █████ █ █   █ ██ ██    █ █ █ █ ██  █ ████     █   █  █  ███  ███     █ █    █ █  ███    █  ██ █   ███       ███     █   ██ ██        █  ███   ██ █     █  █    █ ███  ██  ██   ███   █ █  ██ █   █ █   ███  █ █ █  ██  ██  █  █ ██ ██ ███   ██  █    █  ██     █ ██ ██  █
█ ██   █    ██ █ █  █ ██   ██  █ ██  █ █ █ ███  █    ██ █ ██  █ █ ███ ██   █ ███    █  █    █  ███      ██████ ███ █   █ ██ █   █ ██ ███ ████ █  ██ ██ ██  █ ████████ ████ ████   █  █ ██  ██  ███  ██ ██ █ █  ███ █    █     █ ███ █ █   ██  ████ ████ ██  █ █ ███      ███  ███    ███
████   ██ ██ █ █ ██  █  ███ █ ██  ███   ██       █   █████ ██████ █  ██ ██ █ ██   █  █    ██   █ ██  █ ██ ███    █  █ █   █ ██ ██  █   ██   █  ███    █ ██       ██      ██  █   █ █  ██ █    █    ███ ██ ███  ██ █ █     █     ██  ██       █  █  █ ████    █ █  █  ██  █ █    █  █████
███     █   ██ █ █ ██  ███   █ █    ████ █████ █ █  █  █ █  ██ █  ██ ██ ███  █████  █ ██  ██ █  █ ████ ███    █ █      █  ██         ████ █     █  █ █  █    ██ █ █ ████  █ █  ██ █ █     █   █ █  ██████ ██     █ ██ █  █   █ ██  █ █ █     █ █ ███ █  ██ ██████  █ ██ ███   ██   ██  █
█  █    █      █ ██ █     █    ██  ████ █ █ █ █   █     ██ █  █         ████    █    █       ██   ███  █ ███  █ █ ███   █  █ ██   █  █  ███   █ ███ █  █ █ █  ██ █ ███  █  ███ ██    ██   ██ █ █     ███  █  █ ███  █ █   █  █    ███  █ █  ██  █    █████  ██   █      █ █ ███  █ █ ███
█     █ █  █   ██  ██  █        ████   █ █    ████  █ ████     ██████  █ █   ███  █   █ █      █    █████     █   ██ █  █ ██ █ █    █      █   █   █ ████   ██  █  █ ██ █  ███ █████ █  █    ███ █   ██ █   █ ██ █████ █   ██  █      ███  █  █ █  █ █ ███  █ ██ █   █   █ ███   █     █
██ ███ ███   █    █ █ █ ███  █  ███ █ ██ █    █  █ ████  ███   █ ██ █  █    █ █   █  ██  █    ███  ██  ██ █        ██  █  █ █    █   ████   ████ ███    █  █  █           ████ ██  ███     █ █ ███   █ ███     █  ██ █ █   ███ ██ █ ████  ███ ███   ██   █  ████    █  █      █ █   ██ █
██  █ █ █   █ █ █  ██  █ █  ██  ██ █  █ ██ █   █   █ █  ███       █ █  █    ████      █       █ █  ██  ██  █      █  █  █ █ ███     █   █  ██ ██   ██  █  █   ██████ ████ ██   ██   ██ ███    ███ █    █    █ █ ██ █  █  █ █    █ █   ███   ██   █  █ █████ █ █ █ █ █   █ ██ ████    █ █
█ █   █████   █ █████  █    █  █ ██  ████    ███ █     ███     █████ ████ ████ ███       █ ███    ██   ██ █ █ █ █ █████ ███ ██  █  █     █ ██    █ ████ █  █     ██ █ ██ █████    █ █ █   █ █  ██ ████   █    █  █ █ ████  █     █ █    █     █  █████   ██  █ ██  █  ███ ██ ██   █ █  █
█ █    █ ██ █  ██ █  ███   █ █████ ██             █  █ ███ ███ ███     █  ██ ███  ████ █ ███████ █    █   ██ █    ███ ████████  █  █   ██    █      ██   █    █   ██   ██ ██     ██ █ █ ██ ██ █  █   ██████ ███   █  ███  █    █████  █   █ ██    █  ███  ██    ██       █  █   █      █
█ █   █  █     █ █  █    ████      █    █       ██ █  █ █ █ ███ ██ █   ██ ██ █  ██   ████ █ ██  █████ █     █  █   █   █    ██  █ █ ██    █        ██   ███    ███████   ██    ████ ██ █   █ ██        ██ █  █     █ ██ █  █  ██   █  ████   █  ███  █ █    █  █  █  █   ████ █ █   ████
████ █   ███   █ █    ██    ███    █   ██    █  █ ██   ████     █     ██ ██  █ █ ██ █ █ █ █  █     ███  █  █  █     ██ █████  █ ██ █  ██████   █ █     ██ █████     █    ██ █ █    ████ █ █     █  ██ █  █████ ██  █  ██  █  █   █ █       █     █  █     █  ███ ██   █ █   █  █  ██ ███
█ ██    ████      ██ █   █ █ ███ ███ ██ █   █ █ ██  █ ██  ██    █  █    ███  █ ██ █  ██  ██ █ █  █   █  ████ ██ █  █ █    █ █      ██    ██   ██ █ █ ██ ████ ██ ██ ██ █  █   █  █ █ ██   █ ██████ █ ██ ██ █ ██  ██████ ███ ██ ███  ███  ██ ████ █     █  █    █   █ ██████  ████     █ █
█  █ █  ██ ██       █ ███ █     ███ █  █   █ ███ █  ██  █ █  ██ ███ █ ██ █  █   █    █ ██ █  ███ █ █  ██  █ █ █ ███ ██ ████    ██   █  █ ██  █ █  ████   █ █ ███  █ █   █ █ █ █  ██   █   ██        █  █ █ ██   █  █  █ ███ █   █ ██ █ █ ██      █  ███    █ █  ██   ██    ██        ███
█ █  █ █████    ██ █ ██ ███ █  ██ █ █ █ ██████ █  ██     █  █ ███ █  █   ███  █  █  █    ██  █████   █  ██  █ █ ██    ███  ███  █ ██   █    █  █ ██  ██ ██ █   █  █ ██  ██    █  █ █    ██ █   █ ███     ██ ███  ███ █ ███ █ ██   █   █    █      █   █   █ █      █ █             █   █
██   ██     ██  ██   ██  █  ████  █   ███  █    █ ███ █ █ █   ████   ██     ██ ███  ███ ██   ███  ████  ██      █ █  ██  █ █ █ █  ██     █ █        █ █   █           █   ██    █       ██ ██  █ ██ ██ ██ ██  █ ███ ████ ██ █  █ ██████    █ █  ██   █ █ █ █ █ █ █  █  █  █████ ██ █  ██
█   █████   ██  █  █  █   ██ █    █  ███  █   ████ █ █  ██  █  █     █   ██████       ████ █  █   ████  █   █    █      ███   ███ █ ██ ███ █  █ ██    █ ███    █   █ █  ██  █  ███  █ ██████ ██████  █ █  ██  ███ █ █ █ █ ████ █  ██   ███ █ █   █ ██ █   █  █          ██ █  █  █   ███
█ █ █ ██  █ █ █   █ ██    ███ █ █ █ █    █ ██     █   █ ██  ██     ████  ████ █    ██    █ █ █ █ █ ███     ████      ██  █ █ █ █     █████  █   █           █    ██ ███ █ █    ██ ██   █   ██    ████   █ █    █ █████   █   ██  █        █ ██  █ █ █ █     █ ██   █ ██   █ ████   ██  █
█   ████  ██         ███   █  █   ███  █        █  ██ █  █    █ █ █  █  █ ██      ████ ███████ █ █  ███ █    ███    ██   █   █ █  █   █  ██  █ █   ██ █ █      ████   ██  █     ████  █ █ █ ██  ███ █           ███ ███ █   █ █ ██    █  ██ █     ██    ███ ██ █       █  █  ████   █  █
█ █████   █ ███  █ █   ███ ████     ██    █ █  █ ██  ███ █ █  █   █  █████  ██  ████    █ ██   █   ███  ██   ██ ███ █ ██   ████     ██ █ ███ █ ██ █ ███ █  █ ███ ██  █ █  █    ██  █ ██   ██    ███████ ██ ███ █ █  ███  ██ █ █  ██  ███  █  █  ███ ███         █       ██    █ ████   █
███   ██  █ ██  █   █████  ██     █   █ █ ███ █      ███  █ ██ ████     █ █  ███   ██   ██    ███ ██ ███ █  █ █ █  █ █       █ █   █ █ ███████ █ █████ ██  ██      █ ██    █         ████  █ ██ █   ██   ██ █  ███  █    ██ █ ██ █    █  █  ██ █ █  █  █     █  █       ███ █  █       █
█ █ ██ █ █████  █ █  ████   █    █ █ █  ██ █   ██        ████  █  ███ █   ██  ██    █ ███ █   █ ███ █  █ █  █         █  █  █ ████     █  █    █ █   ███ █████  ████   ████ ████   █ █   ██ █   ███  ██ ██████ ██     ███   █    ██ ████ ███ █ █████   █  ██  ██          ████ █   █ ███
█ █  ██ █   █ █ ██    █ █ █  █ ██  ██   █   █     ███     █ █ ███   █   █  █      █████████  █ ██ █   █   ██ █   █ █  █ █████  █ ██  ██  █     ████  ██ █ ███ █ ██ ██     ███ ████  █  ██  █   ██    █ █  ██  █   ████ █    ██   █ ██ ██ ██ ███ ███ █ █ ██ █  ███  █ ██  ██  █         █
██   █  █   ██ █ ██  ██  █ ██   █   █ █  █ ██    ██ █  █  █  ██  █     ██ █       ██      ████   █ █     ███  █ █    █ █ █ ███  █   ██  █ ██ █  █ ███   ██  █  █  █████  █  ██  █ ██ ██  ███ ██ ██    ██  ██ ██ █ ██  ███ ██████  █  ██ ██     █     █    ███ █ ███ █ █   █████ ███ ██ █
██      ██    █ █ █  ███  ██   ██  █  █ █  █ ██████ █  █ ██ █ █ ██ █  ██ █  ███    ██   ██ █ █ ██  ██   ███  ██   █  ██          █  █ █   ███ █        █  ██  █  █  ██  ██     █    ██      █ █  ██  █  █ █ █ █ █ █    █   █  █ ████  █ ██ ████ █  █      ███      ████    █    ██    ██
██ █    █       █  ██  ██ █  █  ███  █  █████ ██  █ ███         █   ████ █  █ ██  ██ █ █   █  ██        █ ██    █    ██ █  █  ██    █   █ ██ ██    █   █  ██     ███  █   ██ ██ ███   █  ████ █   █   ██ ███ █  █      █ ██ ██   █     ██  █    █ ███ █  █ █  █ ██ █ ██ █ █   █     ████
███ ██    ██ █      █████    ██  █   █  ██  █     ████    ██ ███ █ █ █ ████  █  █ █ █          █ █  ████ ██████    █ █ █    █   █ █ ██ ██      █  █ ██  ██ ██ █   ████ ███ █   █  █  █  █ ████    █   █     ██ ████  ███ █   ███  ██ ████ █ █  █ ████  ██ █ █    █  █ ██ █     █   █  ██
██ ██    ████  █  ██ ████  ██ █ ████   █ ██ ██ ██  █    █ █  ██ █ █ █  ██   █  █████  ████ ██ ██ █  █  █  █ ███  █   ██  ███ ██   ███ █████ █        █    █ █     ██    ███    █    ██ ██  ██ █   ██████  ████ ██ ███ ██    ████  ██ ██ █  ██ █ █ █ ██ █  ███ ███ █ █ ██       █ █ ██ ██
████████████████████████████████████████████████████████████████████████████████████████████████████████████████████████████████████████████████████████████████████████████████████████████████████████████████████████████████████████████████████████████████████████████████████████
