████████████████████████████████████████████████████████████████████████████████████████████████████████████████████████████████████████████████████████████████████████████████████████████████████████████████████████████████████████████████████████████████████████████████████████
█████ ███████████████████████████████████████████████████████████████████████████████████████████████████████████████    ███████████████████████████████    ███  ████████████████████████████████████████████████████████████████████████████████████████████  ███████████████████   ███
████         ███████████████  ███████████     ██████  ███   ███████████████        █████████  ██████████████████████      ███      ██████████   ███████                 ██████      ██████████         ██████    █████████████  ██████████  ████████ ███████    █████████████████     ██
████          ██   █████       ████████        ████          ██████████             ███        ██████  █████████████      ██        ████████     ██████                  ████        ███   ██           ████      ████   █████  █████████    ██████  ██████      ███████  ███████     ██
█████         █     ███        ███████         ████         ███████                 ██          ████    ████████████     ███         ██████       █████                  ███                      ██    ████      ████    ████  █████████     ██████ █████        █████    ██████     ██
█████████    ██     ███        ███████          ███        ███████            ███  ███                   ███████████     ███           ███         █████    ███   ██      █                      ████  ██████     ████     ██████████████     ████████████    █    ███      ████      ██
██████████   ██                 █████            ███      ████████           █████████                       ██  ███      █                          ████████████████      █                    █████████████     ████     ██████  ███████    ████████████   ███   ███                ██
██████████   ██                  ███              ███    █████████            █████████                           ██                                  ███████████████     ████                 ██████████████    ██████     ████     ██████████████  █████   ████ ████                ██
████████████████                 ███              ███    █████████            ██████████                                                               ███████████████   █████                 █████████████     ███████     ██       ████████████    ███    █████████                 █
████   ██████████               ████                     █████████            ██████████           ███                                                 ███████████████   █████                 ██████  ████      ███████               █████████      ███    █████████                 █
███     █████████████           ███                       ██   ███        █   █████████            ████                                          ██    ██████ ███████     ██                      ██              ██████                █████        ████   ██████████                 █
███      █████████████         ████                             ███      ███   ███████              ███                                         ████    ████    █████                                               ████          ███    ███        ████    ██████████                ██
███       █████████████       █████         ██                   ██      ███      ██                ███                                        █████     ███     ████                                                ███     ██  █████             █████    ██████████               ███
███        ██  ████████     ███████        ████                  ███    ████                       ████                                        █████      ███    ████                                                ███    ███████████            █████    █████ █████        ███   ███
███             ██████    ██████████       ████                  ████  █████                       ████                                         ████      ████    ████                    ███                         █    ████████████             █████  █████    ██        █████ ████
███              ███     ██████████        ████                  ███████████                        ███          █                              ███   ██   ████   ██████      ██          ███                             ████████████              ████████████             ███████████
███                     ██████████        ██████                 ██████████                          ██         ███                             ██   ████   ███   ███████    ███          ███                             ███████████               ████████████             ████ ██████
██                    ███████████         ███████       ████     ████                                           ██           ██                 ██    ███          ███████   ███         █████                            ██████████            ████████████████              ███  █████
█        █    ██     █████████████ ███    ████  █     ███████    ███                                            ██         █████                ██     ███          █████████████       ███████                            █████████           ███████████ ██████             ██████████
█       ███  ████   ██████████████████    ███         ███████    ███                                           ███        ███████  ██████       ███     ███           ███████████      █████████                             ███████           ██████████   ██████            ██████████
██      ██   █████  ███████    ██████    ████         ██  ███    ████                                          ███       ██████████████████    ████      ███          ████████████   ███████████              ██                ████            █████████   ██████            ██████████
████████      ████   ██████              ███               ███  ████████            ██                        ████      ███   █████████████████████      █████    ██████████████████████████████             ████                ████                 ████  ██████            ██████████
████████       ██      ███               ███                █████████████          ████             ███     █████       ██     ███████████████████      ███████   █████████████████████████████              ███                 █████                ████████████            █████  ███
████████                        ██                          █████████████         █████             ████████████       ███      ██████████████████      ████████   ███████████████████████         ███       ███      ███            ███              █████████████           █████  ███
██  █████                      ████                         ████████████        ███████             ███████████        ███      ██████   ██    ███      ████████    ██████████████████              █        ███     █████            ███            █████  ████████          ████   ███
█    █████    █████   ██      ██████                        ███████████       ████  ███                ████████       █████     ██████          ███    █████████     ███  ███     ███      ██               ████    ██████             ███          ████       ██████  ██      ██     ██
█     ████   ███████████   ██████████          ██            ███  █████       ██     ███                ███████     ████████    █████████       ████  ██████████     ██                   ███               ████   ██████               ███         ███         ████████████          ██
█      ██     ██████████  ████████████     ███████            █    ███               ███                ███████    █████████    ██████████      █████  █████████                           ██              ████   ██████    ██           ██                      █████    ███         ██
█             █████████    ███████ ████   ███████             ██                     ███                 ██████    █████████    ███████████     █████    ██████                                           █████   ██████   ████          ██                                █████      ██
██           █████████     ██████   ███   ██████              ██                     ███                 █████    ███████████    ████   ███     ████      ████                                   ███     ██████   ██████   ████         ████                               ███████   ███
███         █████████       █████   ███  ████         ████   ████                   ████      ███        ███     ████   ██████    ██     █       ██                                             ████████████████   ██████  ████      ███████        █       ██              ████████████
███         █████████        ███   ████  ███         █████████████                 █████     ██████     ███      ███     █████                                                    ██            ████████████████   ██████   ██      ████████       ███     ████                 ████████
██          █████████              █████████         ██████████████             ████████     ███████    ███      ██      ████                                                    ██████        ██████████████████  ██████          █████████        █     ████                   ███████
█           █████████             ███████████         ██████████████         ███████████     ███████     █                ██                ██                                   ███████       █  █████       ████  █████          █████████             ████                       ████
█          ███████████            ███████████             ██████████         █████  ████      ██████                                       ████                                   ██████           ███         ██    █████        █████████              ███                         ███
█          ███████████           ███████████    ██        ███████████        ████    ███       ██████                                      ████              ██            ██      ████                              ██████████   ██████                 ███                         ███
█          ███████████           ████████████  ████       █████   ████        ██     ████         ███                                ██     ██             ██████         ███                                         ██████████  █████                   ██                         ███
█         ████████████    ███   ████  █████████████       ████    █████             █████                                           ███                   █████████  ████████                                         ██████████  ████                    ██                         ███
██      ██████████████   ██████████   ██████████████       █     ██████           ████████ ██                                      ████                   ██████████████████               ███                         ███  ███   ███     ██              ██                         ███
█████  ████████████████ ████████████  █████████  ████            █████            ████████████             ██                     ████             █       ███████████████           ██   █████                                   ███    ████            ███                         ███
██████████████████████████████████████████████    █████          ████                 ████████            ████                    ███     ██      ███        ██████████             ███   █████                                          ████           ███                      ██  ███
██████  ██████████████████████████████████        ███████                             █████████          ██████                          ████     ████        ████████               ██    ████                                           ████          ██                    ██████████
█████    ███   ███████████████  █████████         ███████                              █████████         █████████                      █████    ███████      ████████      ██               ██                               ██           ██████      ███                  ████████████
████            ███   ███████    ███████          █████                                   ███████        █████████                      █████    █████████     ██  ██      ████               ██                              ███          ███████      █                  █████████████
████            ████ ████████     █████           ████                                     ███████      ██████████                       ████     █████████                ████               ██████                   ██     ████         ████████                        ███████    ██
█████████      ███████████████             ██    ████                                     ████████   █████████                             ██      ██   ███                ████                █████                   ███     ███          ███████                         █████      █
██████████     ███████████████           ████    ███                                ██    █████████ ████████             ███                ██           █                  ███                ██████                  █████                  █████                          ████      █
███████████    ██████████████           █████    ██                        ███  ███████  ███████████████                ████                ███                             ███                █████████                ████                   ████                           ██      ██
███████████    █████   ██████           ████    ███                       █████████████  ██████████████                ████                █████                            ███                     ████                 ███                    ██                                    ██
███  █████     ████     █████           ███     ████                      ████████████    ████████████                 ███     ███         ██████                    ██      █             ██        ███                                                                              ██
██    ██        ██     █████    ██      ███     ████                       ███████████        ███████                  ███    ████          ██████                  ████                   ██                                                                             ███        ███
███                   ████     ████      █      ███                         █████████         ██████                   ███    ████            ████                  ████         ██        ██                                                                            █████      ████
████                 ████     ██████                                        ████████         ██████                   ███    █████             ████     ███        ██████        ███       ██               ██                                                      ██   █████      ████
█████                ████     ██████                                        ███████          █████                   ███    ██████             ████████████       ███████       █████      ██              ████                                                    ███    █████     ████
███████              ████    ███████                                        ███████           ███             █      ███   ███████             ████████████    ██████████      ██████      ███             ████                          ███                     █████     ████     ████
█████████             ███    ██████                    ███                  ████████                         ██      █████████████             ███████████    █████  ███      ██████      ████            █████                         █████                   ███████    ███     █████
███████████                   ████                     ███                 ████████████                       █      ██████████████        ███████████████   █████            █████      ██████           █████       ██                ██████                 ████████   ████     █████
███    █████                  ███      ███             ████      █        ██████████████                             ████████████████      ██████████████    ████              ███        █████           ████       ████               ██████                 ████████   ████     █████
██      █████                 ██      █████   ██       █████             ███████████████        ███                 ██████████████████          ████████      ██                             ██            ██       █████               ███████                ████████    ██       ████
██        ██                 ███       ██████████       █████           █████      █████       ████      ███         █████████████████             ███                                                            ██████                 █████                  ███████             ████
██                          ████        █████████        ████         ██████        ████      ███       █████             ███████████                                                             ███            ██████                                           █████             ████
██                         █████          ██████                    ████████       █████     ███        █████              █████████                                       ██                     ████          ███████         ██                                 ███             █████
█                          █████           █████                ████████████      ██████    ████         ███               ████████         ███                            █                      ████         █████████  █████████             ██                              ████████
█                  ███     ██████          ██████              █████████████     ███████    █████                          ████████        █████                                                  █████         ███████████████████            ████                            █████████
█                 ████     ███████         █████████          ██████████████    ████████    ██████                  ██    ██████████      █████                                       ██   ██    ██████          ███████████████████  ███    ███████ ██       ██              ██████████
█                ██████   █████████    ██████████████      █████████████████   ██████████  ████████████    ████    ███████████████████   ███████                    ████             ███████████████████        ████████████████████████████████████████     ████           ████████████
██  ████    ████████████████████████  ██████████████████  ██████████████████████████████████████████████  ███████████████████████████████████████   ██████    ████████████████      ███████████████████████████████████████████████████████████████████████████████   ██████████████████
████████████████████████████████████████████████████████████████████████████████████████████████████████████████████████████████████████████████████████████████████████████████████████████████████████████████████████████████████████████████████████████████████████████████████████
