██████████████████████████████████████████████████████████████████████████████████████████████████████████████████████████████████████████████████████
██████████████████████████████████████████████████████████████████   ███████████████████████████████  ██████████████████████████████████  ████████████
██████████████████████   █████  ███████████████████████████████          ████████    █████  ██████     ████████████   ████████████          ██████████
█████████████████         ███    █████████████████████████                ██████      ███    ██        ████████          █████               ████  ███
███   ███████                     ████████████████████                     █████      ███               ██████            ██                  ██    ██
██     █████        ███            █████████████████                       ████████   ███                █████                 ███                  ██
██     █████      █████            ████████████████                 ██     ██████████████                ████                 █████                 ██
██      ████    ███████           ████████████████                 ███    ████████████████               ████                 █████                  █
██       ██    ████              ██████   ██                  ██  ███    █████████████████         ██    ███                  ████                   █
██             ███               █████                       ████████   ██████████████████        ████  ███                   █████                  █
██             ███               █████       █████████       ████████   ██████████████████        ████████                    ██████████            ██
███           █████  ████       ███████    ████████████     ███████████████████████████████      █████████          █████     ███████████   ██████████
██████████  ████████████████████████████████████████████  █████████████████████████████████████████████████   ████████████   █████████████████████████
██████████████████████████████████████████████████████████████████████████████████████████████████████████████████████████████████████████████████████
