████████████████████████████████████████████████████████████████████████████████████████████████████████████████████████████████████████████████████████████████████████████████████████████████████████████████████████████████████████████████████████████████████████████████████████
██ ██ █ █ █████  ████        ██ ██   █ █    █ ██  █ ██ ██████████  █ █ ██     █  █  ██    █    █ █    ██  ██ ██  █ █  ██ ███  ████       █ █ ████ ████  █ █ ██  ███      ██ █  ████     █ █ ██   █  ██         █ ███  █ █████  █   █ █  ██   ██  ██   ███   █   █   █ █    ██ █   ███  █
█  █  █ ████  █████ █   ██ █   █ █  ██  █  █ █ ██ ██ █   █  █ █  ███   ███ ██     ██  ████ ███   █ █ █████    ███ █ █ ███         █ █ █  █ █ █ ████ █  ████  ███ ████       █ █ █   ██ ██  ██        █  █        █ █    ██ █   ██████ ██       ██ ██   ███  ███          ██       █   ██
█     █ █ ██ ████████    █  ██  ██  █ ███ █  █  ██ ███   ██ ██ █ ██   █  ███ █ ██ █  █   █  ██  ██  █ █    █   █   ████     ██ ███  █     ██ █  ████  █     █ ██ ██  ████  █████ ██████    ██ █  ██  ██ █ ██  █  █    █ █ █   ███ █    █ █   ████ ██    █   █  ██     ███████     █  ███
███   ██  ██     ███ █ █  ███  █ ██     █ █ ██    ██  ██    ██    █ ███ █ ██   █ █   ████  ██   █    █    █ ████       ███     ██       █  ██ █ █ █    █  ████ █   █████  ██ ██    █    ███ █  █   █   ███ █ █ █ ███  █ ███  ██  ███   █ ██  █  █  ███    ██ ██  ██   ████   █ ████  ███
████ █  ███   █   ██ ██   ███     ███ █ ██████   ██  █ █████  ██    █  ██ █ ██ █ █ █ █    ██  █ █  ██   ██  ████ ███    █ ██      ████     █   █           █ ██ ██ ██ ██ █   ████    ██ █      ████ █     ██   █ █ ██████     █████ █ █  █ █  █   █ ███  █       ██ ██  █   █  ██ █   ██
█ █   ██████  ██   █ █     ████    ██ ██  █ ███     █  ███   █ ███       ███   ███ █ ████  █ █ █ █ █     █     █  █  ██  ███ █  ██     █       █ █  ██   ██ █   ██  ██  ██ ██  ███ ██   ███   █   ███  ███  █ █  ██ █  █  █      █ █     █ █ █   █  ██ █ ███ █████  █  ██  ███         █
█    ██  █  █  █  ██  ███   █   █  █████  ███ █  ██   ██    █ █     █  █ █ ██ █ █  ██ █      █ ██ ██  █ █ ███    ████  █       █   ██  █ ██ █   █ █ ████ █ ███ █      ████    █  █     █    ██   █ █████    █    █    █  ████ ██ ██ █   █ ████████      █ █ ██  █   █████ █      █    ██
█ ███  █   █ █ ███ ██ ██████ █  █ █  ██  ██ ██   █  ███ █   ██ ██      █  █      ███      █████   ██      █  ███ ██ █ █  ████      █   █ ██        █   █    ██ █  █  ████ █ ██       █ █ ████  ████  ████ █ ██  █████   ████ █  █ █ ██   ██ ██  █ █ █ █   █  ██ █████ █ ██   █  ███ ██ █
█  █     ██ █ █ █ ██ █ █  █ ████ █ █ █  █   ██ ███  ██  █ ██ ███ █ █  ██ █  ██ █     ████████   █ ██ █ █ █    ███ █  █     ████ █ █ ███ █ █  ████ █ █ ██████ ██ █ █ ████     ████ ██ █  █  █      █   █  ███       █     ███ ██ █  █  ███         █     █  ██ █ ██ █ ██       ██      ██
█  █  ███  ██   █        █   █    █ █████   █ ████  ██ █ █   ███████ ██   █    █ █   ███    █   █   ██  █ █ █     ████  █ █ ███  █ ████████ █   ██    █  █    █    ███ ██    █ ██   █ █            ██ █   ███    █  ██    ██ ██ █ █     █    ███    █ █ ████       ██  ██     ██ █ ██  █
██    ████       █ █  █  █ ██ █ ███  █  █  ██ █ █   █   ███    ██ █    ██  ███   ███  █ █   ████         █ ████ █   █ █  █  ██   █ █ █ ███  █  ██ █     ██ █    ███    ██         ██  █     ███   ██  ██ ██  █  █  ██  ██  █ █     █         █    ██ █ ██  █ █  █ █  █  █ ███  █   ███ █
█    ██ █ █ █      █  ██ █  ██    ██ █  █     ██    ██  █  ██  █  ██ ████ ███ █    █  ██    ██ █  █    █   █ ██  █   █ ██ █ ██  █ ███    █   ███  █    █ █      █ ██    ███ █████ █  █ █  ██ ██████ █   ██ █  ███ █  █ █      ████ ██ █  ██   █  █ █ █  █ █████     █  ██ ██  █   ███  █
█    █  █ █  █  ███ ██ █    ███ █  █  █   ███ ██ █  █ █ ███             ███ █   █    █ █ █ ██ █ ██ █  █ ███   █    █   █ █  ██ █   █ ██   █ █  ██  █ █     ██ █  ████████ ██ ███  █  █  ████ ██  █   ███  ████ █   █    █ ██     ██   █  █      ██     █  ███ █      █ █ ██  ███ █ ██ ██
█ ██   ███  █ █  █  █  ██    ████████  ██  █ █  ███    █ ██ █ ████    █ █     ██     ██     ██    ████ ████████   █ ██ ██ █ █ █ ██ ███ █      ██ ██ ███ ██████  █   ███ ██ ██  █   █   █ █ █ ███ █████    ██ █ █  ██ ███ ████  █  █ ██ █ ████ ██ ██  ██  ████ █      ███ ██ █ █ █ █ █ ██
██           █ ███████ ████ █     █    █ █   █       ██     █ ██     █  █ ████ █    ███   █ ██ ██  █        █ █ █ ████   █ █   ██      ████ █  █  █ ███ █ █    █ ████   █ ██   █        █  █     ██ ███  █ █          ██ ██   ██ █   ██ █ ██ ██ █   ██ █   ██  █ █  ██████ ██  █       █
██  █  █████ █ ██ █ █  █ ███ ██  ███ █    █ ██ █   █  █  ███  ██ ██    █ █  ███    ██  ██    █ █████ █ █ ██     █  █  ██ █ █    ██  ███ █  █ ███ ███████████   █     █ █  ██  ██      ████  █    ██   ██ █████ █   █ ███ ██   █    ██ █    ███    █ █  █  ██ █ ████ █   ██ ██       ████
███  ██ ██  █ █   █ █ ██ █ ███████ █    ███ ██████ ██  ██ ████ ██  █ █  ███  █    █  █  ███     █ ██  █ █ ██ ███     ██    ██   █   █ ██   █ █  █ ██      ███ █   █  ██    █ █ █ █ █    ██   ██   █ ██ ████ █████ █ █ ██  █  ██  ██  ███ █  █ ██ █   ██ █ █ █ █    ██  █   ████   ██ ███
█ █  ██  ██   ██ █   █ █    █ █   █  █      █ ███            ██ █  █████████ ██ ██████ █   █ █    ██ █ █   █ ██  █  █ ██     █    ███ ██████  █  ██ █  █ ████       ██    ██ ███ █  █         █       █ █ ███  █   ██ █ ███  █    ██     ███ ██ █  █  █ ████  █ █  ██  ███ ████    █   █
██ █  █ ██   █ █ █ ████     ███  ██ █  █ █  ███  ██  ██ ██      ██  █  ███    ██    █  █  █ ███ ███ ████   ███  ████ ████  █       ███  █     ██   ██ ██ ███  ██   █  ██ █ ████  █ █████    █   █  █  ██    █ █ █     █ █   █ ██ ████ ██  █   ██ ████      █   ███ █  ███       ██ █  ██
██ █     █ █ █ ██ █   ██  █ █ █ █████████ █ █ ████    ██  ██   █    ██  █  ██  ██ ████ ████ █ ███     █  █████ █   █ █  ██ █   ██ █  █   ██   ███     ██   █     ██   ██ █ ████ █ █ █ █████ █ ██   ███     █    █          ███  ██ ██    ██ █   █   █ ████   ███    ██ ███ ███ █████ ███
█ █ ██    ██ ███  ████  ██  ██   █  ███   █  █ █    █ ██  ███  ██      █   █  █ █  █  █ ██   █ ██  █     ██ █ ████  █ ██  ████ █  █  ██ █   █ █   ████  ██ ██ ████ █ ██         █ █      ███  ███    █ ██ ██ █    █ █   █ ███   █ █ █   █ ███ ███    ████        █  ███  █    ██    ████
█    █████   █   ███  █ ██   █ ███   █      █     ██    ██  █    ███  ██ █   ███ █  █ █████ █  █  ██ █████  █    █  ██ ██ ██     ████ ██ █  ██████    █  ██  █ █  ██     ███████  █ ███  █ █ █  █   ███  █   ██    █ ██ █  ███  ████     ██    █  ██ ███   █  █████     █   █████  ██ ██
██    █████     █      █ █ █ █ █ ██ ██  █ ██ ████  █   █ █  ███   █        █  ███   █████  █      █     █  █  ██ ███   █     █   ██ ███  ██ ███     █ ██  █ █     █ █        ██ ████ █     █ ████ ██  ██   █████  █ ██  █  █ ███  █  █ ██  █ ██  █  ███    █    ██ ██ █   █ █  █ █   ███
█  █   ██ ██    █ █ ██   █       █   █████ ███ ███    █  █   █  █  █       ███ ████   █ █  █ ██ █    █    █   ███ █ █  █  ██  █ █ ██   ███ █ ███   █  █  ██ ██  ██   ██  █ █ █ █ █   █ █    █  █ █ █  █ ██ █████       ██  █       █ █  █ █      █   █  ██ █   █ ███    ███ █ █ █  ██ ██
█        ██████   ███ █   █ █  ██     █    ██   █ █ █    █   █ █    █   █ █ █ █  █ ██  ███ ██  ███     ██ █  ███ █  █████ █   █  █ █     █ ███ ███    ██ █ ████ █   █   ██ ██ ███   █ █ █   ████      ████      ██  ██  ████ ██  █ █ ██       █  █  ██     ███  █ ██  █  █████ █      ██
███ ██  ███  ██ █  █   █  █ █ █████ █ █ █   █ █ ███ ██ ██  █  █    █  ██   ██████   ██  █ ███████████      ██ ██  ██████    █ █  █   █ ███ ████████ █ █   ██  ██  ██ ███   ███ █   █ ██████        █   ███    ████ █    ██             ██ █ █ ███ ███   █████ █   █      █       █ ██  █
█ ██  █ █  ██  ██  █  █  ███  █    ███  █   █ ████  █      ██  █     ██ ███   ███ █   █ ███ █  █  ███   █ █  █     ████  █ █ ████   █  █     █ ██  █    █ ██████ █  █    █ ███ ███ █   ███  █ ██      ███ ██  ██        █  █     ██ █  ██  ███     ██ ██ ██████ █ ████ █ ██ █ ██ ███ █ █
██ ██  █   █   ██ █   ██  █   █    ███ ███ ██  ███  █ █ ███ ████  ███ █ █  █           █ ████   █   █    █ ██ █ ███    ██████ █    ███   █       █ █ █ █ ██ █  █  █  █ ████ █ ██  █   █ ██ ██ ██    █ █  █ ██  █ ███ █  █      █ █    ███    ██ █   ██    █         █          █   █ ███
██  █████ ██   ███ █ ██ ███ █     █ ██   ████  █  ████  ███   █        ██  █  █ ███ ██       █  ███  ██    ██   █████    █    ██  █  ██  █ ███ ████   ███ ██    ███ ███    █  ██ ██   █   ██   ████   █ █ █   ██ █        ███ █ █ █ █         ██   ██ █  ███  █ ██ █    ██ ██ ██  █   ██
█  █ █ █    █ █   █ ██   █ █    ███████ ██ █   ███      █  █  █ █ ███ █ █████ █████  ███     █ ████ █   ████   ██  █  ██  ███████ ███ ███   █ █ █    ██       ██ ██   ██ █   ██  █ █████ ██████ █   █  █  █ █████ ████ ████ █ █   ██  █  ███ ██ █ ███ ██ ██       █ █████  █  █ ██     █
█ ██  ██  ███  ██  ██ ██ ██   █████  █ █  █ ██ █  ████  █ █  ██ █   ████  ██    █ ██    █  ███   █ ███ █   █  █ █      ██  ██ ██ █   █  ██████   ███████ █  █    █    ██   █ █   ███  █  ██    ██ ██ ███ █  █   █ ██ ██      ███   ██ ██  ██  █  ██  ██    █   █████ █ █ █  ██ █  █ █ ██
██  ██ █  █   █ █  █    █    ██ █ █      █ █  ██  █████  ███ █   ███ █ █     ██ █   █ █ ██ ████ ██ █  █ █  ██  █ ███  █ ██  █ ██   ████ ████  ██ ██ ███      █ ██  █████    ████ █       █ █   ███ █ █    █    ██  ██ ████ █ █  ███  █  ██ ███ ██  ██ ██ ██  █  █ █ ███  ███ █      █  █
█ █ ███ █ █   █ ██  ███     █ ███  █ █ ██    ████   ██ █     ███     █ ██  ██ █ ██ █      ███ █ █ ██ ███    █    █  ██ █  █   █    █ █  ███   █ ██ █  █ ████   █  ██ ███        ██    ███      ██   █   █ ████ █ █ █ █ █  ████     ██ ██  █  ███ ██ █ █ ███ ██  █        ██ █ █  ██ █  █
█    █ █  █ █  ██       █   █ █ ████ ██   ██ █ ████ █ ███████   █ ███ █ █ █ █  ███ █   ██ ███  █   █ ███  █ █  █ ███ ██████ █   ███   ██   ██  █  █ █ █ █ █ █ ██ █ █  █  ████  █ ██ █  █ ██ █     ██    █  ██ ██    █   ███ █   █      ██    █ █ ██████ █    █   █    ██   ██ █  ██  █ █
█    ██ █        █   █   ██ █ █  █  █        █    ████  ██ █ █  █   ██ ██ █    █ █ █ ████  █      ███   ██ █████ █   █ ███ █   █ █    █   ██████    █  █ █  █   █ █ █ ████ █ █   ███   █ █  █    █ █    ██       █   ██ █  █ ██████     █ █   █  ███  █           ██    █   █  ███     █
█ █   ██  █  ████ █      █  ██  █████  ████ ███    ████     ███████  █ █  █ █ █  ██        ███     ██ █   █       ██      ██ ███  ████    █ ████ █ ██  █████   █ █    █  ███  ██ █     █ █ █ █    ██  █ █   ███ █   █  █  █  █   ███   █ █    █    ██             ██ █  ██          █  █
█ █  ████████  █  █ ████  █  █ ███    █  █  ██   ██     ██ ██    █  █ █ █ ███  █   █ ██ ████   ███ █████████ ██ █    █ ██ █     ██ ███ █   ██ █   █  ███    ██ ███ ███     ███ ██  █ ███  █████ █  █ █ ███    ██  █  █ ██   █████ █  █ ███████  ███████ ███ █████ ██   █   █   █ █ ███ █
█ ██ █ █  ██ █ ██  █   ██ █ ███   █ ████  █ █ █  █ █   █ ████ ███ █ █          █     █ █ ███  █ █     ██  ███ █  ██ █    █  ██    ███ █     ██   █  █      █      █  ██ █       █████ █  ██ █   █ ███  ████ █ █ ███ ██      █ ███   ██ █  █  ██ ██  █ ██ ███ █ █      █ █ █ █ ██ ███ ███
█   █ ████ █   ██ █      █  ███ ██  █ ██ ██  █ ███ ██   █ █ █    ██ █    ████ █   █ █    ██ █    █   ████   ██ ███     ██ █ █      ███  █   █  ██ ████ █     ███     ██  ██ ██   ███  █ █     ██  ████ ██  ████ ███ ██    ██  █ █    ██  █  █ █    █  █ ██  ███ █    █  ██  █  █ █ █  ██
██  ██   █ ██ █ ██ █ █ █ ████   █     █   ████ █    ██ █   ██           █ █ █  ██  ██ ██ █ ███ █████ █    █  █ █   ██  █ █  █  █  █  █   █ ███   █   █████   █ ███  █   █ █    █   █  █   █ █        █    █ ███   █  ███ █    █ █  █    ██ █ █  █ ████████   █ █ ██ ██   ██    █ █ ███ █
█ █ ██    █ █ ██      █  █  █   ███ ██ ███    ████  █ █  █  ███ █ ███ █   █ █████        █      █ █ █ █     ██     █    █ █   █  ███    ███  ████   ██ █   ███ ████████ ███ █    █  █  █ ██ █  █    ██   █ ██   ████  ██  █ █ █  █ █   █  ██ ██ ████████  ███ ███  █   ██ █ █ █       ██
█ █    ██   █ ██ █ █ █ █ █ █  ████ █   █   ██ █████   █      █     █    █    ████   █    ██  █ ██████ █  █ █ ██    █     ██    █  ██  ██ █  ███        ██  █  █  █   █  █ █   ██     █   █ █  ██  █████ ██ █████ █  █ ██ ████    █  ██ █  ██ █   ██     █     ███ ██████ ███ █ ███  ██ █
█ █     █     ███ █  █    █  █████ █   ██ █   █████         █████  █     ████    █ █    ██ █   █ ██████ █     █ ███        █   ██ █  ████  ██ █ ██  ██ █  ██ █  █ █ █ ██   █ █ ███    ███  ██        ██   █ ███        ██ █ ██   █ ████ ███  █ █ ████  ██ █         ██     █████ █  ████
██████ ██  █     ████ █ ███    █ █ ███ █  ███  █    ███ ██    █  █              █████      █ ██ ████ █    █ █     █  █  █  █    ██ █ ████████ ██ ███     █ ███   █   ██ ████  █  ██ ██ ███ ███ ███    █      ██   █      █ █     ███ ███   █  ████  █ █ █ █ █      █ █ ███   █████     █
█  █ ███   █  █ ██ █  ███ █ █ ███   █ ██  █ █   █   ██ ██   █     ███  ██    ██ █  █ ██  ███ █  █ █ █  ██ ███ █     ██   █████ █   █  █ █ █  ████ █ ███  █    ██              █   █    █ ███ █  █ ███  █   ████ █ █████   █   ██  ███ ██   ██ █       ██       █  █       █ █   █ █ ██ █
██  █ ███     █       █  █     ████ ██ █  ████ ██  ████  █ ███ ██   █ █ ██  ████    █     █  ███  █    ██    ██  █ █  █ ██ ██    █   ███    █ ███    ██ █ █    ███ ██    █  ██  █    █  █   ██ █ █     █  ██ █ █  ███   ███  ██   ███ ██      ██ █ █████    ████ ██   █ █  ███  ████ █ █
██   ██ ██ █    █  ███ █████████   █ ████  ██ ██ █    █ ████ █  █ ████ █ █████  █     ██ ███ ████ █  █ █  ██   █ █       █  █ █  ████ █    █  █ █ █   █ █ █   █    ██ ██  ████  █ ███  ███  █    ██   █  █ █ ████████ ██     █ █   █  ██    █ ██       █  ███  █ █    ███ ███ █  █    ██
██      ██     ████ █ █  ███  ██ █   ██     █  █ █    ██ █   ████      ████ ██ ██     █   █ █ █ █    ██    ████   ██  █  █  ████  ███    █ █ ██ █ █  ██ ██████  ██ █  █      █  ███ █    █ █    █ █████ ██ ██████   █ █  ███           █   ███ ██  ██       █ █ █       █  █    ██ █  ██
█  ██     ███     ██ ███ ███ █  ██   █   █  █ █  ██ ████   ███ █ ██    ███     ██  ████  ███  ██ █  █     █  █ ██████ █    █████  █  ██ ███ █ █  █  █ █  ██ █    █  █ ███ █  █    █ █  █  █ █  █ █    █          ██ ██  ███  ██       █ █████  █████ ██ ██           █       █   ██    █
█ █   ██ █  █          ██  ██ █ ███   █  █ ██ ████     ██ █ █  ██   ██ █  █   █ ██ █ █    █ █ █ █  █    █      █ █ █████ ███     █ █ █  █  █   ██ █    ███  █    █ █    █ █  █      ██  ██████ █ ███ ███ █     █  █    █ █   ██  ████ ███ ██ █  █   █    █  █    █ █     █  ██   ██    █
██ █  ██ ██  ███   ██ █  █  █   █ ██ ██       █ █ █  █ █ █ █ ████ █ █  █████  █ █  ███████   ███ █ █ ███ ██ █    █   ██ ██ █   █    █  █ █ ██ █ ███      █ █ ███ ███      ███       ██    █  █ █ ███     █    ██ █  ██ ██ ███ █  █ ██  █   ██ █   ██ █  █  ████ ██ █ █   █ █ █     █  ██
█       █   █  █ ██ █ ██  █  █  ██ █ ██ █  ██ █ █ █  █ █ ██ ████    █  ████ ████ ██ ███ █ █ ██ █   █  ███  ███ ██     ██ █  █ ██       █    █  █ ███ ██ █ █ █    █    ██   █ █ ████      █ █  █ ██ █ ███ ██ █ █  ███ █ ██    █    █  █    ██    █     █  █ ██ ██ █ █   █ █       █  █  █
█        █        █  █   ███    █ █    ██ ██  ██    █ █   █████ ██  ██     █    █   █   ██  █ █  ███   ██      ███    ████ █  ██  █ █    █        ████ █ ██  ██ ██ █  ███ ██     ███ ███ ███████   ██ ██ ██  █ ██  ██  ██ ██ █   █     █ ██   █   █ ██  ██     ████  ██ █  █       ██ ██
█     █ █ █ █ █    █  █ █      █ ██ ██  █      ████ ████      █  █  █     █   ███   █ ██ █     █ ██   █ █ ███ ██   █████     █     █ ██████ █ █  ██    █████ █ ██   █  █ █  █   █  █ ████  █   ███   █    █ █ ██    ██ ██  ██████ █  ███ █ █   █ █  █  ██████ █  █ ██ ██ █   █ ██  █████
█ █ █  ███   ████ █   █ █     █    █████   █  ██  █    █   █  ██████  █  █ ███    █ ██   █  █     █ ████  █ █ █  █    █  ███ ████    █  ██ ███ ███  ███  ████ █  █ █  █     █       █  ████ █  ████  █  █      █  █ █ █  █   ████ █ ██ ██ ██   ██        █ ████ ██    █    ██ ██ █████ █
██   █   ███ █ ███    █  ██   █    █   ███ █ █  ███ █ █   ███ ██    ████   ██  █    █████  ███ █ ███ ██████ ██   ██      ██  ██ █         █    █  █ █      █ █ █████  █     ██  █   ██ █████ █   █ ████  █  ██    ██          █████ █    ██ ██ █  █ ███ ██   ██  █ █     █  ███      ███
█    ██     █  ██   █   ██ ██ █  ██ █ ██████  █ █   █ █ █   ██   █  █ ███ ███   ████  █   ████   █  ██████ █ █  █ █    █ ███  █   █  █ ███ █ █  ██   █ ███     █ ██ █  ██  █ █   █ █████ ████ ███   ██   ██ █       █      █ ██ █ █ █ █ █████   ██ ███  █ █ █      ███ ██ █   █ █ ██ ███
█ █ █ █ ███ █████  ██    █    █    ██  █  █ █ ███  █ █  ██     █ ███ █  ██  █  █ █    ████ █  █  █          █      █  █   ██ █ █    ███ █ ███ █ █    ██ █  ███   ██ ██ ███  █   ███    ███████  ██ █    ███ █  ██    ███ █ █ █   ███ ██  █  ██    ███████ █ █  ███ ██     ███ ██ ███ ███
██ ██ █ █  ██  ██ █                █   █ ████  ███ █  ████ █   ███ █   █      █  ██ █   ███   ██ ███    █       ██  █    █ █████ █  █ █ ████    █  █   ███   ██  █ ██   █ █████  ██  █  █████  █ ██ █ ██          ██  █   ██ █     █ █   █  █ ██  █ █ ███        █ █ █████ ███  █  █ ███
█ ████     █     ██ ██ █  █  ██ █   ███    █ ████  ███  ██      ██  █   █  █ █  █████    ██    ██ █   ██   █ █    █ ██     █  █ █  █ █████  █  █   █  █ ██     █ █ █ █ █ ██          █ █  ████ █ █   █      █ █  █    █    █ ████ █        █ █  █  █ █ ███ █ █    ██ ██  ██ █████    █ █
████ ██  ██   █ ████ ███████████ █ ███ ██ ██    █ █    █ ███   ██  ████    ████  ██  █ ███████ █ █  █      █   █  ██  ███ █ █      █ █████        █        █    ██ █   █ █  ██ ██      █ █  █     ██ █ █████    ██   █ ██  █  ████      █ ███ █ ███  █ █ ██  █  █  ██    ██   █  █ █ █ █
████ ██  ██ █    █   ███   █ ████  █ █ █ █  █ ████     █  █  █ ██   █    █ █ █  ██ █ █       █ ████   █ ███████   █      █   ██ █   ███ █ ██ ██ ██ █  █ ████████   ███  ███  █      █ ███ █ █ █ ███    ██ ████   ████  █ █     █        ██ █ █  ██   █ █  █ █ ██ ██    ██ ███  █████ ███
█   ███   █ ████ █        █  ███  ███    █  █  ███ █  ██  ██    ████      █   █ █ █      █    █ █ █   ██  █ ███    █ █ █ ██   ███ █ ██  █ ███ ██    █ █ █ █  █ █     █ █ █ ███ █  █     ███ ███  █ ██ █  █ █ ██ ██    ██████  █    ██   █      █   █      ██ █ █  ██    █ █    ██ █ ██ █
█    █      █   ███  ██ █ █    ██          ██  █ █     ███     ██ █ █  █  ███ ██    █   ████ ████   █   █ ██ ██ ██     ██ ██  ███        █ ██████    ██   ██   █ █ ███ █████ █ █ ████  ██  █ ██            ████ ██   █   █  █  ██    ██  ██  █  █    █  █    █ ██ █    █ █████ █ ██ █ ██
█ █   ████    ███ █    ██ █  ███ ███  █ █ █  █████    █ █████   █   █  ██    ████   █ ██  ██ ███ █ █   ██    ██  █ █    █ ██ ██    ██████████               ██  █ █  ████   █     ███   ██ █    ██████  █ █ ███ █  ██     ██ █ █ █     █████   █   █ █    █ ███ █ █   ████   █  █   █  █
██ █ █ ███ ███ █    █     ██ █  █     ██ ██ ███ █  ███ ██   ███ ██  █       ██  █ █     █    █     █   ███ ███ ████ ██ █  ███  ███ ██ █    █  ██  █ ██ ███████  ███ ████    █ ██       █ █ ██ ████  ██ ███ ████ █  ███ █      ████ ██     ████    █     █  ██   ██      █  █ █ ██   █  █
████████████████████████████████████████████████████████████████████████████████████████████████████████████████████████████████████████████████████████████████████████████████████████████████████████████████████████████████████████████████████████████████████████████████████████
