████████████████████████████████████████████████████████████
██████████████████████████████████████████ █████████ ███████
████ ████████████████████████████████████   ███████   ██████
███   ███████████████████        ████       ██████    ██████
███   ██████████████████          ███      ███████   ███████
███   ██████████  █████            ███   ████████   ████████
███████████████    ███              ███████████     ████████
███████████████    ███              █████████       ████ ███
██████████         ███               ███████         ███ ███
█████████                                ██          ███████
█████████                                            ███████
███  █████                                          ████████
██    ██████                                 ███████████████
██   ████████                               ████████████████
█████████████             ██                ████████████████
████████████   ██    █   ████              ████████      ███
███████████    ██   ██████████           ██████          ███
███████████         ███████████         ███              ███
███████████          █████  ███        ███               ███
████████████         ████    ███      ████               ███
████████████         ████    ███     █████               ███
███████████         ██████           ████                 ██
██    ████         ███████            ██                   █
██             ███████████                                 █
██           █████████████                 ███       ███████
██        ███████████████                  ███       ███████
██       █████████                    ██   ███      ████████
███      ████████                    ████  ███     █████████
████     ████████                    █████████    ██████████
█████    ████████     ██             █████████    ██████████
██████   ████████    ████            ████████    ███   █████
██████   █████████   ██████          ████████     █     ████
█████    ███████████████████        ███  ███             ███
████    ████████████████████       █████████             ███
███     █████   ████████ ████      ██████████           ████
███      ██        ███    ███      ███████████          ████
███                        ██        ██████████        █████
███                                    █████████   █████████
███                                      ████  █████████████
████                                            ███       ██
████                                                       █
████                                                       █
████                                                       █
█████               ███                                    █
█████               ███                                    █
████                                                      ██
████                           ███          ██           ███
████                          █████        ████  ████    ███
████                         ███████      ███████████    ███
███                           ██████     ████████████     ██
██                               ███    █████████████     ██
██                     ███              ████████████      ██
███                    ███             █████    ████      ██
███                     █              ████      ██       ██
██                                      ██                 █
█                                                    ███  ██
█    ███  ███                                        ███████
██  ██████████████    ██████    ███                 ████████
████████████████████████████████████   █████████  ██████████
████████████████████████████████████████████████████████████
