████████████████████████████████████████████████████████████████████████████████████████████████████████████████████████████████████████████████████████████████████████████████████████████████████████████████████████████████████████████████████████████████████████████████████████
█ █ █ ██   █    █    █  ██   ██ ███████   ████ █ ███ █████ ██   ███  ██  ██  █     █  █  ██  █        ████  █   ████  ██ █  ██ █████  █     █ ████  █ ██ █  ████     █ ██   ███ ███  ██ █ ███  █    █ ██ ██     █  █ ██    █   █  ████  █   █ █ ██  ██  ████  █ ████ █ ██  █████     █ █
███ █  █ ██ ██ █  ██  ██   █  █████ █  █ ███ █       █████ █ █ █ █   █   ███  █  ███  ███   ████      ███ █ █ █████████     ██  █  ███  ███  █   ██    █   █ ████  █ ███   ██  █         █   █     ██   █  ███     █     █ █     █   ██    █ ████   █  █ ██   ██ █      █ ██  ███  ██ ██
█   ██ █   ██████  ██    █  █ ██   █  █  █ █████  ███   ███ █████ ██  █ █ ██ █ █  █ ███  ██   █   ███ █    ███ ██  ██ ██  █ █  █ █  █ ███████ █   ██  ███ █ ████   █ █   █ █ ██ ██ ██  █████  ███   █  █   ██   █  █ ██ ███    ███  █  █   █  ██  █████ ██   ████  █  █  ██   █ ███    █
███ █  ██ █   ██  ███ ███   █    ██  █  █  █    ███   ██    ██ ██ ██  ██ █ █  █ ██  ██      ████ █ █ █ ████     █   █       ██  ████   ██   ██  █ █ █    █ ██   ██  █ █████ ██     █   █ █  █ █    ██ █   █ ██ █       █  █████        █    ███  █       ██ █████   █  ██ ██ █ █   █ █ █
█ █ █  █ █    █       █    █  ███ ██ █ █  █ ███  █      ███ ██  ████ █   ███████ █  █ █  ████ █ ██████    █ ██   █ ███  ██  ███  █ █ █ █   ███ ████ ████ ██ ██ ███████ █  ██    ████ █ ███ █████   █ █████  ██ █ ██  █ █ ██   ████   █ █    ████ █  █   █   ██  █    ███ █ █   ██ █  █ █
██████ █   ██  █    ██ █████  ██    █    █ ██  █  ██        ███ ██████ █  █ ██ █  █  ███ ██ █ █  ██   ██   █     █████   █ █    ██   █    ███ █        █  █ █ █      ███    █     █     █   █   ██ █ ██   ██ █ ██  █    █████ █  █ ███ █  ██ █ █  █ █ ██ ██  █     █  █  ███ █ ███  █ ██
█   █  █  █      ██ █ ███     █ ██  █    ███ █      █ █  ██ █      █   ████   █████  ███ █ ██ █ ██ ███     ██ █     ████   █ █  █ ████    █    ██   █ ███ ██  ██████ ██ ██          ██    █  █ ████ █ █    █ █████ ██  █   █    ███  █   ██      █  █   █ █  █████   █ █ ██ █ ███ █ ████
█ █  ██      █   █████ ██ ██  █ █ ██  █  █  █ █ █  ███ ██ █ █   ██  █    █ █  ██  ██ █   █ █ █  ██ ████  ███ ███   ███  ██ █ ███ █ ███   █    █    █           █  ███  ██  ██   █  ██      ██  ██ █ ███  █     ███   ██ ██ █     █  ██ █  █        ███ ███ ██   █ █ ██ █ █ █  ████   █ █
██ ███  ███████ ██   █  █ ██  █ █  ███ ████ █     ██       ██   ███  █   █  ██ █ ███ █     █ ███      ██  █   ██     █    ██       ██    █    ██ █ ██       █ █ █ ████ █   █ █  ███       █   █ ███  ██   █   █ █ █   █ █ █ █     ██   █ █████  █    ██ █ █ ███   █ █  ██  █     ██ █ ██
█ ███ █  ██ █   █    █ ██    █  ███  █  █   █ █  ██ ██ ███████  ██ ████   ███ █   ███     █ █  ██  █  ███    █  ██ ██  █    ██      ██  █         ██   █ █ █ ██ ██   ████████  ███ █ █  ██   █  █         ██  █  █  █ ██ ███             █  ██  █  █ █    █    █████  █ █    ███   ██ ██
██  ████   █  ████ ██ █   █ ███    ██  ███████  ████ █  ███ ██ ██   ██ █  █           █ █ █ ██ ██ █  █    █ █  █████ ███████████ ███   █ ███████  ██ ████  ████ █       ███████ ██ █  ██  ███  █    ███  ███  ██  ███ █ █ █    █   █ ██  █    ██  █ █ █  ███   ████ ███ ███ █   █     ██
████ █ ██ ███ █ █   █   █ ██   ███  ████  █    ██  █  █    ██ █ ██████████ █ █  █████  ██ ████ ██ ███ █ █ █ ██ ██    █   ██   ██ █  █ █  ███    ████ █ █      █ █         ██ █ █████ ███ █████     ██   ███ █ █     ██  █ █    █    ██  ███  █  █ ██     ███     █ ███   ███   ██  █   █
████  █   ██ █   █  █ █  ██ ██   █████  ██   █  █    ████ █ █   ██  █ ██   ████   █    █ ████ █      █ █ █  █   ██  █  ██  █   ██       ███  █   ██    █ █   ███ ███ ███  ██         █ ██████ ███   ██  ███     ████ █  █ █  ███ █   █ ██    █  ████ █████ ██ █ ███  █          ███ █  █
█████  █ █ ██ █ █    █  ████ ██   ██ ██████     ██ ██    █ █████ █  █  █   ██   █ ██ █   █  █   █  ██   ███  ██ █ █  █ █    ████ █  █ █ █ ████  █ ██           █   █ ████  █ █ █ █  █    ████   █████    ██     ██████  ██████     █  █   ██ █████████  █  ███      █    ██████ █ ██ █ █
█ █   ██      ██   ████  █ █ ██    █ █  █    █ ███  █ █ ██  █████████     ████ █ █     ███ █  ██ █          █    █    ██   █████  █  █  █    ████   ███  █        ██ █████ ██ █ ██ ██ ███ ███   █  █   █ ██  ██ █ ██    ██  ██ █ ██ █  █   ██ ███ █ █ █   █   ███  █ ██  ██  █ ██   █ ██
██ █  █     █  █  ███      █  █ ██ █ ███ █    █   █   ████    █ █  ████  █   █     ████  █ █  █  █  ██    ███ ██ █        █  █  █    ██    ███      █  █   ████ █ █ █   █  ██  █ █ ███  █ ██  █   ██ ███ ██ █  █   ██        █ ██ █ █ ██    █  █  █  █   █    ███   █   █    █ █   █   █
███ ██ ██    █ █   █████  █ ██ ██   ██   █  █   █   ██ ███  █  █ █ █ █    ██    █ █  █ █   █ █     █    █  ██  █  ██ █  █ █  ███  ███  ███ █  ███   █   ██    █ █ █   █ █ █   █ ████ █  ████ ██ █   █  ███ ██  █ █████     ██ █   ██ █     █  █ █ █    █ █ █      ██     ██   █ ██ ██  █
██████    ██ ██ █ ███    █ █ ██   █ ██  █ ███   ██████ ██   ███  ██ ██ ████ █         █  █ █        █ █  █████ ████ █ █ ██  ██ █ █  █  █    █ █  █     ██ █ █     ██  ██ █ ███   ██   █  █    █    █ █████  █ ████     █ ███    █  █ █ █ █████   ██ █ █████  ██ █ ███ ██  █    ███████ █
█ █  █  █      ██████ █  ██ █  ██     █      █   ██       █ █  ██  █ ██ ███ █          ██████   █  █  ██  █ █ ██   █ █   ██  ██ █ █ █ ███  ██   █  █  ██  █   █   █ ██   ██  █ █ █   █     ██ ██  ██    ██   █    █   █  █  ██ █ █  █ █ █ ██████  █  █ ██   ██       █ █ █ ██    █  ██ █
██  ██  █ █   █   █ █   █   █ ████   ███ █  █ ███ █ ██  ███ ████ ███ ██████   █ █ ████     ██   ██   ███  ███ █ █ ██ ████  █  █ █ ████  █   █  ██  █ █ █████  ██  ██ █     ██  █ █    █ ████  █ █  ██  ██    ██ █████    █ █  █ ██ ██  █   █ ██   █████ ████   ██ █ ████  █  █  █   █ ██
█ █   ██  █     █     █  █  █ ██ █ ██ ███   █ █ █ █ ██   █ ████    █ █████       █     ██  █ ██ █ █      █               ██ █   ██      █      █ █   ██ █  ███ █      █  ███  █ █        ███       █  ██ ██ █ ████ ████     ███ █ █  █    █      █ █  ████  ██   ███████  ██ ██ █ ██████
███ █ ██ █ ██    ████ ██ █  █████ ███ ██ ██ █  █ █      █ █████ █ ███        █    ███  ██ █  ███ █ █ ████    ███ █ █ ███ ████     ██   █    ███  █ █    █  █   ███  █  ███   ███  ███    ████ ██   █    █     ███    ██    █  ███     █ █ ██    █  █  ██ █ ███   ██      ██  █   █ █  ██
███  ███ ████   █ ███  ████   ████   ██ ███     █  █ ██  █  █    ███ ██   █ ██    █ █ ██ ██ ███  █  ██  ██ █ █ ██ █   █   ██   █  █ ███    █    ██     █   █        ██       ███████  ██ ██   ██  ██ █  █       █   █ █  █  █  ██  █     ██    ██ █     ████ █     ██ █ █ ██ █ ██  █  ██
█  █ █ ███ █    ██ █ ██     ██ █   ██  █ ███ █   █ ██ ██ █   ██ █ █ ██ █ ██  █ █ ████ █   ██ ████ █ ██ █    █ █   █ █ █   ███ █  █ █   ██████ ██ ██      ██ █   ██     ████ █         █  ██ █ ██   ██  █████   █  ██  █  █    █      ██  ██ █ █  █  ██ ████  █ ██       █  ███  ██ ██  █
██ █ ████ █  ██ ██     █ ███ █   █   ████  █  █ ██  █ █ █     ██       ████ ████████ █████ █  █     ███  ██ █ ██████  █ █    ███ ███      █     █  █    ██  █  █   ███   █  █   █ ██  █ █  ███ █   █ █      █        ██   █   ███   █ ██  ██   ██   █ ██  ██ █  ██ ██ ████ █   ██  █ █ █
█████ █ ███   █      ██ ██ █ █   ██ ██  ████  █    █████ ██         █  █████ █ ██  █ ███ █  █      ███   █  █    ███ ███ █   █  ███       █████     ██ ██ █ █  ████     ███ █   ██    █ ██   ███████    ██ █ ██ █    ██ █ █ █      █   █ ██ █ █ █  █ █         █     ██    ████   █   ██
█   █ █ █  ██   ███    ██    ██  █  █████ ██████  ███       █  ██ ██ █ ████ █ █ █ █ █  ███  █     █ ██  █   █  ██ █   █ █ ██ ██ ████ ██ █     █  █ ██   ██ █ ███ ██  ██ ██ █   ██ █ ██████ ██  █ █  ███ █   ███ █  ██  ███ ██ █ █ █ ██ █      █  ███   ███████ █  ███    ██   █  ███  ██
██   █████   ██  █  ██  █ █  █████    ████ █        █ ███ ████ █    ██  █  █ ███  █ █       ██  █   ██ ███   █   ██ █    ███  █ █ ██ █  █ █  █████ █   █ █  ███     ███  ███████ █ █ ███ ███         █   ██  ██ ███ ██ ██ █ █     █   ██  █    █    █   █  █ ██  █ ██████  ███  █ █    █
█  █ ██ █ █   ██ █████ █ █          █ █ ███ █ ██ █  ███  ███       █   ██    █  ██ █  ██   █ █      █   ██ ██ █  █    ████ ██   █  █ █   █ █  █████ █ ███ ███████   █ ██     █  █  ██ █   ██  ███ ██  ██  ████ ██  █ █   ██  ███     █ ███       ███    █████ ████ █ █ ████   █ █   █  █
█  █ ████████   █ ███████   ██     ██    █       ████ ███ █  █    █      ███ █    █  █  █████  █ █    █   ██ ██     ███ ██    █  █████   ████ █ █ █    ████████  ██  █   █   █ █   █ ██    █    █    ██   ██ ████   █  █     ██        ███  █      ██    █ █     █ ███ █ ███           █
█   ██ ██    ██   ████ █  █  ██  ██ ██ █ █  █   ███ ██ █████     █  █ █ █  █   ██ █  █ ██       ██  █ █ ██  ███          █   █    █ █   █ ████ █ █  █ ███  █  █ ██ █         █ ███ █ ███   ██ █ █ █  ███ ██  █  ███ █   █ █ █ █ █ █ ███████   █   ████       █ ███  ██   ███  ██   █ █ █
██ ███       █ █ ███ ██ ██     ██ ███ █     █████ █   █ █  █ ██████ █ █   █ █  █████ ███  █       █ █ ██ █    ████ ██   ████   █ █ ███  █  ███  █  █ █ ██    ███  ████ █    ███ █ █ ██ █ ██   ██  ███ ██ █  █  █ ███  █  █  ███████ █   ██     █ █ ███ █   ███ █ █     █       █ █  ██ █
███  █ █ ███ █   ██    █ █ █ █  █ ████  █ ██           ██████ █    █   ██  █ ███  ███ ██  ██ ██    ██    ██ ██   █   ██  █  ████   █ ███ ██ █  █ █ █  ████ █ ███   █      ██ █    █ █ █      ██ █ ███ ████ █      █      ██   ██ ██      █     ██ ██ ██ ███  █   █ █      █  █ ██  █   █
█ █ █    █ █   █  ██  ███ ███ ██  █ █    █ █ █   █  █  █ █ ██   █ ██   █ ██ █    ██ ███ █  █ █ ██   █  ████   ███ ██  ███ ██ █ █     █ █ ██████ █ ██  ██     █       █ █    ███ ██ ██  █ █   ████ █  ██ █ ██ █ █ ██  █ █     █    ██  ███    █  ██ █ ██  █   █   █ █    █████ █ ██ ██ ██
███ ██ █   █ █ █  █ █    ██    █ ███ █    █  ██   █    ████                █   ████ ██ █ █ ███   █     █   █  █  █ █  █  █   █ ██ █ █ ██  ███ █ ██  █   █ █    █     ██ ██  █  █ ██ █   ████   ██ ██         █ ███ ██  █ ██ ██ ██  ████      ███ █  █  █ █    █  ██  █  █  █    █ ███  █
█ █     ██ ██ ████   █  ██  █  █ ██ █ █       █ ███   █ █ ██  ██  █  ██        ██████ ██ ███████ █████ █ █     █  ███ █ █  ███ ██  ██  ██  █ ███ ██  █ █    █████  █ █    █ ███      █████  ███ █   █   ███  ███  █   █    █  ███  █ ██   ██   ██ ████   █    ██  █  █ ██████    █  ██ █
███    █        ███  ██ █ █  █ ██      █████    ███   █    ██    █   █  █  ███ ███ █  █ ██ ████  █     █ █       ██   █ ███ █   █ ██ █ █ ██ █   █ ███  █ ██ █          █ █  █    █ ███ ███    █ ███  █   █  ██ ██ ██ █   █ ██ █ █       █   █ ████ █ █    ███ █   ███     █   █    █████
█  ██████  ██ █ █  █    ████    ██  █ █   █████  █  ███  ██ █ █  █ ███ ██ ██ ████  █ ██  ████   ████  █ █ █   █  ██ █ █ █   ██ █ ███ █ ██  ██  █ ██   █ █ ██████   █ █   ██   █  ██   █  ██  ███    █ █   █ █ ████  █████  ██  ██ ██ ██    █ █ ███ ██  █    ██      █   ███ ██  █   ████
█ █  █ █ ██   ██████  ███    ███ █  █ ██   █ █   ███      ███ ██████ █ █   ███       █ █ █     ███ █  █ █ █ █ █  █  █ █ █      ████ ███ █ ████ ███  ██  █████  ██     ██████    █  █       █ █ ██  ███  █ █   █  █  ██  ████ █          ██  ███ █ ███ ██  █   █     ████ █    █  █ █ ███
█    █ █ █   █  ███   ██ █████   ██ █     █ ███   ██  █ █ █ █   ██ █ █ ██     █  █ █   █ █ █ ████ █  ███ ██ ████  █  ██  ██ █  █ ██   █ █   ██          █   █   █  ██   █   ██ █    ███ ██     █ ██  █  ████   ██ ██   █ █     █   █ █ ███ █ ██   ███  █     █    ██  █   ████ █    █  █
██ █ ██ █  ███ ██    █  █  ██   █ █  ████ █    █ █    █ █   █    █ █ ██ █ █ ████ ███ ██     ██ ██ ██ █   ██ █ █  █ █ █  █   █ █ █ █ █     █  ███   █      ██ ██  █ █ █   █  █ █ █████ ██  █        ██████     ███   ███ ██  ████ █   █ █ █ ██    █     ██ █ █ ██   ███    █  ███     ███
█  ███    █ █   █   ███ ██     ████  █ ██ █ █  ██  ███████ ████ █ ██ █ ██      █ █    █   █ ██   ██ █ █       █ ██        █   ███ ████ █ █ ████ ████ ██      ██ ███ █    ███ ██   █    ██████ █ █  █     █    █ ██ █ █  █       █  ██ █ █    █ █  █ █  ██ █ ██ ██  █  █      ██ █  ███ █
█  █ ██  █ ██ ██ ████ █ █ █ ███  ██  █ █  █ ███████ █   █ ██ ██  █ █ █ ██  ██ █ ██   ███████ █     █    █ ████ ██   ████████    █  ███  ██ █    █ █  ████  █    ██   █ █ █ ██  ███  █ ██ █ ██  █ █ █  █   █    █ █        █  █    ██████  ███  █  ██  █  ███  █ █ ██████ █  █    █ ██  █
██ ██ ███  █ ████  █    █ ███       ███    █  █  █ █      ██ █      ██         █ ████   █      ███ █  ████   █   █ █    ███ ██  ████  ███   █ ████ ████  █ ██ █     █ █    ██ ██ █ █     ██       █       ██  ██   ██ ██     ██████████ █        ███    ██ █      █    █     █      ██ █
█     █   ██  █  █████ ████ █ ███  █ ███  █  █ ██        ██ █ █  █    ████████████     ███ ████  █     ███ ██ █ █  ██ ███   █           ███ █ █     ██      ███  █ ██ ██████  ██  ███ █████ █ █ █     █  █     █          ████ ███ █    ████ █ █ █  ████ █   █████ █   ███ ██ █ █ ███  █
██   ██    █   █ █ █ █████      ██ ██ █    ████  ███ █ █ ██      █ ██ █  ██      █ ███     █  █ █   █  █      █   ███   ███████ █    ██  ██  ██ █ █ ███  █    █  █ █ ██  ███  ██        ██     ██ ████ ████ ███ ██ █   █      █  ██    ██    █████ █ ██  █ █ ██  ██ █     ███ █ █   ████
█     █  ███     ██  █       █ █ █████ ██ ████ █ ██  █ █ █  ██ █       █ █   █ ███  █ █  █   █ █   █ ███  ███  ███ █    ██   ██ ██   █ █ ██████     █  █ █  ██████  █ ██ █   ██ █ █    █    █ █       █ ██ ███ ██ █   ██ ██    █ ██   █       █     ███   ██ █  █  ███ █      █   ████ █
█ ████     █  ██ ███  ███  █     █ █   ████   █ ██  █ ████ ██     █ █████ █ ███     ██ █  ██   █  █  █ █   ██  ██ █    █ ████  █████   ██   █ █ ██  █   █ █ █ █   ██ █              █ ██   ███ ██   ███   █ ██  █   █     █   ██  ██ ██ █ █ █ █   █ █  █ ██ █  █  █  █████ █ ██    █   █
█  ██  █  ██  ███      ██ ██    ██   ██  ██          ██  █    █ █  ██████  ██      █ █ █  █ █  █ █ █ █   ██ ██ █  ██  ███ █ █ █  █   █   █    █ █  █ ███   ██  █     █    ██ █  █ ██ ███  █ █ █████  █ ██ █ █  ██  ███    ████  █ ██   ████    █   █ █   ██     ███ ██ ████  ████      █
█ █████ █ █  █   █████ ██  ██ █     ██ █    ███ █  ██   █    ██   █  █ ██  █   ███   █ █   █  █ ██    ██    █  █ █ ██  █   █   ███ ████ █ ██  █  ██   █  █  ███  ███ █   ██   █ █ ██ ██ █ █ █ ██ ██   ███ ██     █  █    █ ██  ██  ██ ███ ███  █ █  █       ██ ██ █   █   █  █ █  █  ███
█  █  ███  ███ ██        ███   █ ██ █     ██████ █    ███  █  ██ █  ████ █ █ ██  █ ████   ██ ████ ███████  ██  █  ██ █ ██ ████ ███  ██    ██ █  █  ██   █ ██  █  █            ███    ███   █ ██  █ ██ ███ █   █  █ ███ █ █ █ ██ █  ██ █       █    █    █ █  █████    █ █  ██ █████    █
███    ██ ██   █ ███  ███ ██  █ ███  █ █  █ █  █ ███  █ ████       ██ ██ ███ ██ █ ██████ █ ███  █ █ ████ ████ █   █    ██ █ █  █  █ █   █  █ █ ██  ██ █ ██ ███  ████    █  ██ ████ █  █    ██   ████     █    ██   ██     ██    █ ██ ██ █ █    █ █████ █████ ███████ ███ ██ █ █████  ███
█     █  █  █ ██  █ █ ███  █ ██ █   █   ██ ██ ██ ██ ██    █     █ █     █    █  ██  ███ ██ ██     ███    █  █  ██ █  █      ████ ██    █ ██  ███ █ █  █   ████ ███  █   ██ ██  █   ██   ██    ██ █   ██████ █ ██ ██  ██   █ ███ ███    ██ ██ █  █ █       █ ██   █  █    █ ██   █  ██ ██
█   █ ██ ██  ████ ███ █ █ █  █      ██  █ ███ ██  ██ █  █    █ ██      █  █ █     █     █  █  █  ██ █  █ ██     █    █ █ █ ███  ██  ██ █      █   ██  █  █  ██  ██████  ██  ██     ███    ██ █████ ████    ██  ███ ██ ██ █ ██  ██ ███  █ █  █    ███    █ ███ ███ █ ██ █ ████  █ █  ████
██  ██    ██ █ █ █  ██ █ █  ██  ███   █  ████ █ ██    █ ██ █  ███ █     ██ ███  ███ ██ █████  █  ██ █ ███ █   ██   █       █  █ ██   █ ██ ███ █ ██ █ ██  ██  ██ █ ███ █ █████ █ ███ ███ █ █ ██    ██████ █  █████ █  █  ██  ██  █ █████    █ █ ██  ██████ ████   █████ █  ██  ███     ██
██   ██ █  ██  ██ █ █  █  █ ██ ██    █   █ █    ██████   ██  █ ██   █  ███ █  ███ █ ██    █████  █     █ ██     █   █    ███ ███  █  █ ██ █████ █████ ██  ██     ████ █ █  █   ██  █  █ █    █   ███ ██   █    █ ███ ███  █   ████       ███ █ █ ██  █     ███   ██████   █  █   ██   ██
█ █ ██   ██ █ █      █       ████  █  █████ █  ███ ██ █  █ █      ███ █ ██████ █ ██ █  █     █      ██ █ ███  █ █  ██ █ █  ████  █  ██ ██  ███████        █  █ █ █ ████      █ █ █ █      █ █ ████   █ ████ ███ █ █ █████      ████   █  ██     ███    ██   ██   █ █  ██ █ █  █   █    █
█        █     ███   █ █   █    ██  █      █ █  ███  █  █    █   █      █  ██ █ ██  █    ███ ██ █ █ █  █ ████ ██  ██  ██ ██   ███  ██  █    ██ █ █     ██ ███    █ █ ████    █ █ █ ███    █   ███ ████  ███    █ █    █████ █  █ █      ███████  ████ █  █   ████    █ █ ███ █    ██  ██
██  ██     █ █  ██ █ █ ██  ████ █  █ █ ██  █ █   █  █  ██   ███  █ ██  █ ███   ███   █   █   ██ █ ██ ██  ██   ██  █████████ ██    █ █████          █ █    ████  █ ██ ██ █████ ██ █     ██ █ ███ ██      ██   ██  █ ███   █ ██ █ █  ██  ███  ██ █  ██    ████ ██ ██ █      █  █ ██ ██  ██
██        ██ █     █  █  ██ █ █ ██   ██  █ █ ██  ███      █   █████ █ ███  █ ██ ████      ██ ██  █  ███   █  █ ████ █   █  █   █ █  ██  █   █    █ █ █████  █ █     █  █ █  ████   ██   █  █  █  ██ ███  ██  ████ █  ███       █  █ █ █     █    ███   ███   █     █ ███   █ █  █ ████ █
█    ██    ██  █ █  ███   █ ██ ██     █ ██ ██ ███  █    ██ ███████████ ██ ███     █ ██ ██    █████        █ ██  █   ███       █ █ ████ ██ █ █████   ██       ███ █ ███  ██    █  █   ██  █ █ █  █  ██ █   ██   █ █  █     █ █  ██     ██ █  ██  ██ █   ██    ██  ██  █ ██ █ █  █ ██  █ █
█      ██  ██ ███   █ █ ███ █ █    █   ██ █   █ █  ████ ███ ██   █   █████ █ ██     █    █ █  ███   █ █    █ ██       ██ █ █   █  ██ █    █  ███  ███ █████ █ █ ██    █ █ █████ █████████   ██ █  ██   ███      █ █ ███ ███████  █   █     ███  ████ ███ █   ███ █ █ ██ ██   ██ ███ ██ █
█   █         █ ██  ██ ██  █ █  ███████  █     █   █   ██ ██ █ ████       █    █     █  ███ ██ ███     █ ███  ████   █ ██     █ █  ████      ██ ██    ██    ██ █      ████    ██  █████   █  ██  █ ██ █     █    █           ██████     █   ███ ████ █ █         ██   ████  ███   ██████
██   █  █ ███  █     █     █  ███  █ █ ███   █ █     ██  ██ █  █  █ █  █ █ ██ ██  ███  █  █ █     ███   ███████   ██ █ ████████  ██████ █ █████   █ ██  █  █     ██  ███ █ █ █ █  █ ██    ██   ██ █ █ █ ██ ██ █ █  ███ ██ █  ██  █ █ ███  ██ ████ █ ██  █    ███ █  ███ █  █ █   █████ █
███   █   █ █   ██  █ █  ███ ██      █  ██ █    ███ ████ ██ ███   ██   █  ███  ██ █ ██   ██ ██    █ █ █  █      ██ █  ████     █ █  ███  █  ██    █ █████   ██ ███   ██   ███ ███  ██ █  █    █   █ █ █ █   ██  █ █ █ █   ████    █  █ ██ █    █ ██ ██    ██ █   ██  █ ███  █ █   █ ████
█  █ █    ██   █     █ ██ █  ███ █  ███    █ █ ██ █     █  █  █ █ █ ██████    ██  ███ ████ █ █████  █████    ██     ███  █       █ ███ █ █  █    ██ ███ ██  █ █       █ ██ █     █ █   ███  ██  ██ █ ██ ██          █  █ ██      ██   ███        ███   █    ███  ██  █  █    █    █ ████
████████████████████████████████████████████████████████████████████████████████████████████████████████████████████████████████████████████████████████████████████████████████████████████████████████████████████████████████████████████████████████████████████████████████████████
