████████████████████████████████████████████████████████████████████████████████████████████████████████████████████████████████████████████████████████████████████████████████████████████████████████████████████████████████████████████████████████████████████████████████████████
███████████████████  ██████   ████████████  ██████████████████████   ████████████████████████████████████   ███████████████████████████████████████████████████████████████████████████████   ███   ██████████ ██████████████████████████████████   █████████████████████   ██   ██  ███
████████████████                  ███████       ██  ███████████            ████   ████     █████████████             ███████  █████         █████████████████████████████████████████████               █████  █████████   ███████   ████████        ██   ██████████████              ██
████████ ██████                    ██████            ███████                                ███████████               ██       ███             █████████████       ████████   ██████████                 █████ ███████      █████     ███████                ██████████               ██
███████████████                    ██████            ████                                    ██████████        ██                               ███  ██████         ██████    ███████████                █████████████       ███      ███████                 ████████                ██
███████████████                    ██████             ██                                      █████████       ███████                     ██         ██████         █████     ███████  ████               ████████████                 █████           ██      ███████                ██
███  █████████                     ███████                                   ███               █████████      ███████                ███████         █████          ████       █████    █████              ██████  ████                ████      ██  █████      █████                 ██
██    ███████                      ████████                           ██  ██████                ████████      ████         ██       ████████          ████          ████        ███      █████              ████    ████               ███      ███████████     █████                 ██
██    ███████                       ███████                          ███████████                ███   ███    ████         ████     ████               ████          █████                ████                ████    ██               ███       ███████████      ████                 ██
███  ███████                         █████                            ███████████               ██     ██████████         █████   ███                ████            █████              █████                 ███                 ██████         ██████████      ████                 ██
████████          ███                 ███                              ████████████             ██     █████████          ██████████                ████             ███████          ███████          ███    ███                ███████          ██████████     ███                  ██
███████          █████     █                                            ████████████                   ████████          ███████████                ██         ██    ████████        ████████         ████     █         ██████████████            ██  █████                          ██
███████         ███████   ███                                                 ████████                ████████          ████████████                                 ████████       ██████████        ████              ██████████████                  █████          ███    ██      ██
██████         ████████    █                            ██                     █████████              ████████          █████████████                                ████████    █████  ███████        ████             ███████   ███                    ███          █████   ███     ██
█████       ███████████                                ████                    ██████████              ██████           ██████████████                                ██████     ████    ██████        ████            ███                                            █████   ████    ██
█████       ███████████               ███          ███████       ███           ██████████              █████            ███     ██████                                ██████     ████    ███████       █████            █            ███                               ███     ███    ██
██████      ███████████              █████        ███████       ██████         ███████████             ████              █      █████                                 ███████     ███    ███████       ██████               ███     █████████                                  ████   ██
███████          █████              ██████        ██████        ██████             ████████       ██    ███                     ████                                  ███████     ███    █████████  ██████████             █████   ███████████              ██                █████   ██
████████          ███               █████        ███████        ████                 ██████      ████    █                     ████    ███                               ███      ███     ████████████████████            ██████   ██████████              ████            █████████████
████████                     ███   █████         ███████        ███                   ████       ████                          ███    ████                               ███     ████       ██████████████████            █████    ████   ██     ██         ██            ██████████████
████████               ████████████████          ███████        ██                               ████           ██████               █████           ███                 ███     ████        ███████████████                        ██         █████                      ██████████████
████████              █████████████████           █████         ██                               ███           ███████              █████           █████    ██          ████   █████        ████   ███████                                   ██████                       ██  █████████
█████████             ██████████    ████           ███         ████                              ███          ████████              █████           █████    █           █████ ██████       ████     █████     ███                            ██████                            ████████
██████████             ████████      ███                     ████████             ██            ███          ███████                 █████  ███      █████                ██████████        ███               █████            ██             ███████                           ████████
███████████            █████         ███    ████            █████████            ████         ████          ██████                    █████████      █████                 ███████          ██                █████           ████            ████████                          ████  ██
████████████            ███         ████   ██████          ███   ████             ████     ██████          █████                      █████████      █████                  █████                              ███           ██████            ███████              ██████     ████    █
███  ███████            ███       ██████  █████████       ███     ██                ███    █████          ████                        ██████         ████        ████  ██    ████                                            █████                █████            ████████    ████    █
██    ██████           █████     █████   ███████████     ████                        ███   ████          ███                           ████          ████       ██████████    ███    ███                                     ███                   ████           ██████████   ████    █
███     ███            ██████     ███  █████████████     ████                         █    ████           █                                           ██        ██████████    ███   ██████  █              █                  █                     ███         ████████████   ████   ██
███             ████   ██████          █████████████      ██                               █████                                  ██                           ██████████           ██████████             ██                                       ███        ████████████     ███   ██
████           ██████   █████          ████████████                                        ████████                               ███                         ████                  █████████                            ██          ███           ████        █████████        ███   ██
████          ████████   ████           ██  █████      ██                        ██        ████████                               ████                        ████                 █████████                            ████        █████         ██████       ████████         ████ ███
███            ███████   █████              ████      ████          ███       █████        ████████     █                          ███                        ████                ████████                              █████      █████      ██████████       █████            ████████
██                █████  ██████              ██       ████   ██    █████     ██████        █████████                                █                          ████            █████████                                 ████      ████     ███████████         ████            ████████
█       ██         ████   ██████     █                ██████████   ██████    ██████       ██████████                                                   ███      ████          █████████                                   ███       ██      ██████████           ███             ███████
█      ████        ████    █████    ███               ██████████    ██████    ████       █████   ████        ██████                                   █████      ████         ███████          ████                                          ████████            ███             ███████
█       ██        ████     ██████    ███              █████████      █████    ████       ████     ███       ███████                                   █████       ██           █████     ███████████                                            █████             ███            ███ ███
█                 ████    ████████   ███             █████████        ████    ███        ███      ████      ███████                                  █████                       ██     ████████████                           ███                ███      ███     ██           ███   ██
█                 █████████████████   ███          ███████████               ███         ███     █████      █████                                    ███                               ████████████                           ██████                       ███     ███         ███    ██
█                  ████████████████    ███     ███████████████    ██          █      ██  ███    ███          ███       ████████                      ██      ████                     ███████  ████                      ██  ████████                       █       ███        ███    ██
██                  ██████       ███  █████    ██████  ██████    ████               ████       ███                    █████████          ███        ███     █████                     █████     ██            ██        ██████████████                              █████       █     ██
██                                █████████     ████    ████     ████               ████       ███                    █████████         ██████      ███     █████                    █████                   ████      ███  ███████████                        █   ████████           ██
██                                █████████     ███               ██               █████        █                           ███         ███████     ███     ██          ██████    ██████                     █████   ████          ████   █                    ██  █████████          ██
██                      ██        █████████     ███         ██                    ██████                                     ██          ███████   ███                 ███████████████                       ███████████            ██   ███                   █    █████████         ██
███  ███               ████  █     ██  █████   ████        █████                  ██████                                     ██          ████████████                 ███████████████     ██            ██  ████████████    ██                                      █████████         ██
█████████              ████████         ███████████       ██████          ██      ██████                                     ██          █████ ██████                ████████████████    ████           ████████████████   ████                                     █████████         ██
█████████              ███████          ███████████       ██████          ██        ███                   █                  ███         █████   ███                █████████████████    ████            ██████████████    ████             █                       █████████         ██
████████               ██████            ██████████       █████            ██                            ███                 ███         █████   ███          ███   ██████████████████    ████                 ████████     ██             ███                ██    ██████████        ██
███████                 ████                ████████       ████             ██  ██                       ████                 █          ██████   ██          ███   ████   ███    █████     ███    ███          ███████                    ███  ███  ███      ███  ████    ███       ███
█████                   ████       ██        ████████      ███      ████    ███████                       ████                    ██      ████     ██         ███    ██             ███      ██    ████          █████                      █   ███  ███       ████████     ██       ███
████                   █████      ████         ██████     ██        █████    ███████                      █████                   ██               ███        ███                    █       ██   ████████      █████                           ███  ███       ████████     ██        ██
███       █          ███████      █████         ████     ███           ███    █████████                    ████                   ███               █        ████        ██                  ██   █████████    █████                            ███  ███      █████████    ███        ██
███       ██    ████████████      █████                  ███            ███    ██████████                  ████                    ███                       ███        ████                ███   ████████    ██████                ███              ███     █████████    ███        ███
███       █    ████████████       █████   ██             ████           ████   ███████████                 ███      █              ████                      ███        ████      ███      █████   ████       ███████             ███████             █     ████████     ████        ███
███            █████   ██         ████   ███             ████            ███    ██   █████                 ██      ███             █████████                            ███     ██████    ██████              ████████          █████████                  ████████     █████        ███
██            ████                ████   ███             ████            ███          ████                ███     ████              █████████                           ███    ███████    ██████              ████████         ██████████                  ███████      █████        ███
██           ████                 ████  ███             █████   █       ████           ██                ████     ████              ████████                            ███     █████      ████               ███████         ███████                      ██████        ███         ███
██          █████                  ███  ███            █████   ███   ███████                            █████     ███              █████████      ███████               ███       ███                          ███           ███████                      ██████                     ███
███         █████                   █   ████          ██████    █████████████                          █████      ███              ████████      ████████        ███     ██       ███                                       ███████                       ██████                     ███
█████        ████                       █████        ████████      ██████████                          █████       ███             ███████       ████████        ████    ███      ███                  ██                   ███████                       ██████                     ███
███████       ███                       ██████       ████████       ████████          ███              █████       ████             █████        █████           █████    ██      ███                 ████                  ███████             ██        █████                       ██
████████       ██      █                ██████        ████████       █████           ███████████        ███         ███              ███          ███      ██    █████            ███                █████              ████  █████████         █          ███            ███         ██
█████████      ██     ███              ██████            ███████      ██            ████████████████                                                      ███    █████            ███                 ███              █████   █████████                                ██████       ███
█████████      ███  ████              █████               ███████                    ██   ███████████                                          ██        ████    ████             ████                                ██████   █████████           ███                 ███████      ████
██████████    ██████████              ████          ██    ████████        █████              ████████           ███   █████                   ███████    █████  █████             █████                          ██████████    █████████      █████████    ███        ████████      ████
████████████████████████    ███      ██████  ██    ████  ████████████   █████████            █████████  ████████████████████       ████      █████████  █████████████            █████████                  ████████████████  ███████████   ███████████████████████████████████    █████
█████████████████████████  █████████████████████  █████████████████████████████████████████████████████████████████████████████████████████████████████████████████████     █████████████████████   ████████████████████████████████████████████████████████████████████████████████████
████████████████████████████████████████████████████████████████████████████████████████████████████████████████████████████████████████████████████████████████████████████████████████████████████████████████████████████████████████████████████████████████████████████████████████
