████████████████████████████████████████████████████████████████████████████████████████████████████████████████████████████████████████████████████████████████████████████████████████████████████████████████████████████████████████████████████████████████████████████████████████
█  █  █ █     ██ ███ █ ██  █████ █ █   █ █   ████  █    ████ █ ███  █ ██   █████ ██ █  ██ ████  ██   ██    ████   ███  █████  ██  ████     █  ██       █ █ █ ██ ██ █ █████  █  ██  █  ██████ █  ██  █  ███   ██   █   ██ ███ █   █  ██      █  ██    █   █  █ █   █ ██ █ █████ █ ██    █
█  █ ███ █ ██ ██ █  █ █ █ █      ██ █      █ ██ ██  █    █   █   █  █  █  ██ █    ██ ███ █   █ █  ██     █  █ █        █  ████████  █ ████████ ██ ██ █ ██ █ █   ███ ██ █ ███ █ █   █    █  █   █  ███   █ ███  █ █  ██   ████    █ █  █      ██ ██ █ ██████ █   █   █  █    ██  █   ██ █
██  ████ ███ █████      ██     █ ██    █ ██ █ █  █  █   ██    █████████ █ ██  █       █ █ ████  █████ ██ █  ██    ██  ██ ███████    ████      ██ █   ██      █ █ ██   █    ███   █ █     ███ █  █████  █  █ ██  █ ██ █      █ ████  █ ███    █  █  █    ██ ██   █   ███       █  █   █ █
██   ██  █ █  █   ███████ ███    ████ ██  █ █   █ █  █  █  █ ███    █ ███████   ██ █ ██    ███ ██   ██    █████ ████ █   █ ██   █ ███   ██ █ █  █ █ ██  ███  █    ██  █ ███ █     █    ██ ██  ████  █   █  ██  ███   █    █ █ █████ █  ███  █ ██ █   █ ██   █ ██ ██████ ████  █  ██ █ ██
█       █  █ █   ██  █ █ █         █ █  █   █  █ ██   ██████  █ █  █ ███      █  █ █   █  █     ██   █   █  █  █ ██  ██     ██ █       █  ███      █     ██ █  ██    █   ██ ███    ██  ██ █    █ ██     ██  ██ █ ██  ████        ████ ██  █ █   █  ███ ███  ███  ██  █  █ ██      ██████
█  █   █ ██ █ █ █   █ ██       █ ██  ██   ███    ██    ███ █  █    █  █ ██████ █    █  ██ ███     ██████  ████ █   ████   ██     █  █ ██ ███   ██ █ █  ██ █  █████  ██████   ██ ██ █    ██  █   █ █   ██ ██  ████   █ █      ███ █   ██████ ██    ██    █ █ █  █████ █ █   █   ████ █  █
██    ██  █ ██ █ █   ███  █   ██   █ █  ███ █ █ ████   ██ █  █   █ █     █  █ ██  █  █ ██ ██ █  ██ ██   ██  █ █ █  ██ ███ █  ███    █ █     █████    █  █  █████ █ ███     █ ██  █ █ ██ █   ███  ███  █ █   █   █ ███ █    ███   █    █   ██   █  █    ██   ██ ██ █  █  █    █ █  ██ █ █
█ █ █  ███  █  █ ████ █ █ █   ███  █ ██ ██ █    █  ████  ██  ██  ███  ██ ███    █ ██ █ ██     █ █  ████  ██   █      █  ███    ██ ███    ██       ██  █ ██ ██   ███ █████  ██ █ █      █ █  ███ █  ██ █   █     █ █ ██  █ ██ ██ █  ██ ██ █  █████  █       ██ ████  ███  ██ █ █ ██   █ █
██   █   ██ █ █  █      █ ██ █  █ █     █   █ █  ██      █ █ █ ██     ███████  ██   █ ███    ██ █    █ █    ███       █    █ ████      ██ █ █ ███ ██ █  ██    ██ █  ████      ██  ███ █  ██████████ █  █ █ █       █ █   █  █ █████   ███ █ ████    ██ █  █ █ █   █ ███ █     ██       █
█ █    ████       █ ██ ██ █ █    █     █ ████ ████ ██ █ █  █  ███    █  █ ██  █ ████   █ █     ██ █  ██   ██ █ ██   █ █  █ ██   ██   █ █ ██ ███   ██    ███ █   █   ████    ██ ████ █  ██ █ █  ██  █  █ ██   ██     █  █  ██ ███ ██   █  █       █   █████   █   █ █   █  █ █    █     █
██        █   ██ █  █ ███  ████           ███ ██ █████ █ ██   █ █   █ █ █  █   █ █ █ █ █ █      ██     █       █    ██  █ █ █    █   █ █ █ ██  █ ████ █  █ █   █ █    █    ██ █  █     █  ██    ██ ██  █    █ █  ████ █ █   █  █████    █ █  █    █ █ █     ██  █  █ ██ █    █ ███    ██
█ ███  ██████ █    ██ ████ ██  █ █  █  ███ ██     ██  ██ █  █  ██████ ██ ██ █  █     ██  ██    ██  ███ █    ███   █ █  ████    █  ████  █ ███ ██  ██   █  █  ████  █  ██  ███ █ ██ ███   █      █ ███     █ █  ██ █ ██ █  █ █ █    ███  █ ██ █    █    █  ██ █ █      █  ██   █   ███ ██
█ ██  ██     █  ███ ███ ██  █     █ ██████        █ █ █  ████  █ ███ ██     █ █ ██  █  ██ █ █  █  █    █ ██████   █       ███ █ █ █   ██  ███ █  ███ █    ██ █ ████      █ ████ ███████ █ ███ █  █ █ █ ██ ██   ███ █ ██ █ █ ██            ████ █ ███         █ █ █ █ █ ██  █  ██ █   █ █
███  █  █ █  █  █ █ ████ █  ██  ██ ███  █ ██  ████   ██ █   █  ███  █ ██ ██     ███    █ █    █ █ ████   █     ███   ██ █  █ █    ████ ███ ███    █   ███   █     ██  █ █ █  █   ██ █     ████ █ █       █    █   ██  █ █ ████ █ █      █  █  █ ██ ██ █████   ████ ████ █  █ ███    ████
███        ████ █  ███ █ █ ███ ███ █ ██ █  ██   █  ██ █ ███ █  ██   ██    █ ██ ██ ██ █ █ █    █  ██ █  ██ █  ███ ██ ██   █       █      █   █ ███    █     █████  ██          █ █ ███ █     ██    ████    ██  █  █ █  █ █ █ ██  █     ██  █     █  ███   █  ████   █ █ ██ ██  █ █ ██   █
█ █ ██ ██ ██ █   ████  █ █ █    █████  ████ ███  ███████ ███ █  ███   ██ █   █ ██ █ █   ██████ █  ███  ███    ██ ████ █ █ █  ██  ██ █  █  █  █ ██  ████ █  █  █ ████  █           █   ████ ███ ██     █ █ ██ ██  █ █   █  █    █ ███    █   ██    █  █ █ ████   █  █  ██   ███ ██ █    █
█ ███ █ █ █  █    █  ███ ██ █ █ ███  █ ███     █ █ ██  █  █ █ ██ █       █     █ █ ██████  ██ ██ █  ███  █ ███   ██  █ ███ █   ████  █ ███ ███   ███ ██ █           █   ██   ███ ██ █ █ █ █       █ ██   ██     ██    █   ██ ██    ██   █   ██ ███ █     ██  █ █    ████ ██  ███      ██
███ █ █    ███ █  ██ █ █ █ █ █ ██ ██ █ ███████ █ █   █  ██ █  █ █   █ ██████ ██ █ █  ██ ██  ███ ██  ██    ███ ██      ██ ██ ███ █ ██ █ ██   █  █      █ ████ █  █ ████ ███ ██ █ █  ████  █  █   ██ █   ████ ████ █ ██    █  ██  █  █ █    █ █ ██  ██     ██      ███ █    █ ███ ███  █ █
█ █ █ ██ █ █ ███   █ █  ██ ██ █  ██    ███    █ █   ████ █       ███████ ██ █  █ ██      █████   ████    █   █  ██████ █ █ ██     ███    █  █  █ ███████ █   █ █ ██      █ █ █  ████ █ █  █ █   █   █ █ ████      ██ █ ███  ███ █ █  ██  █████ █  ████    █   █ █ ██  ██ ███ █ █ █     █
██ █ █  █ █  █ ███████ █  █       █ ███   ███  █  █ █ ██ ████████ ███ █  ███  █  ███ ██  ███ ████      ███  █  ██    ██   ███    ████  ██     █ ███  █ █  ██  █  █   ██  █  ██  ████   ██  ██ █  █████      █ ███████    █ ████ ██    ███  ███ █████     ██  █ █ █ ██  ██   █  ██  ██  █
████  ██   ███ █ ██ █████ ██   ███ █      █       ██ ██ ██ ██ █ █████   ███ ██  ███ █  ██ █    ███   ██ ███ █ ██  █    ██ █ █ ██ █ ████  ███ ███   █    █   █ █  ██ █ ███ ███ ██ ██ █ ███████      ██ █ ██       ███    █    █████    █  █ ███   █ █ █ █ █  █  ███  ██   █ ██   █      █
███ ██ █ ██ ███   ███ █████ ██  █ █  █   █   ██ █ █   ██   █ █ ██   █  ███ █ █  ██ ███ ██ ███ █      █ ███ ███  ███ ██ █ █  █ █ ██ ███      ███ ██    █ ███   █  ██       █████  █  ███ █ ██ ██  █ ██   ██ █████   ████  █  █       ██      ████ ███ ██  █    █ ████ █    █ █ █  ██ █ ██
██  ██    ███   █     ██   ████  ███  ██████ ███████  ███ █       ███ █ ███  ██  █ █ █ ██  █████     █   ██   █   ██   ███  █ █     ████  █████   █    █ ███  ██ █  █ █ █████   █   ███ █  ████  █     █  █ █  ███ ███         █   █ █  █    █ █  █ ██ ██   █  █   ██  ██  █    █ ██ ███
█ █ █   ███   █████ ██████ ██       █ ██ █ █  █  █    █   █  █ ██ █ ██  ██  █   ██  ███  █ █       ██  ███        ███  ██ ██   ██ █ ███ ██  █     ████ ██  ████  █   █  ████  █     █    █ ████ █ ██ ███ █      █    █   █   █ ██ ███  █  █  ██    █ ███    █     █   ██  ██  █ █ ██ █ █
█  █████  ██  █  ███ █  ███ ██  █ █   ███ █  █  █  █  █   █ █ █  ██  ██  ███     █ █████ ██   ██  █ █ ███  █████  █  ████     █ █ ███ ███   ██    ██ █ █ ██ █ ████ █    ████   █████ █  ██ █ ███ ██  █ ████  ██   █   █ █  █  █  █ ████  ███████ █ █ █ ██ █ █   ███ ███ █    █  ██     █
████ █  █ █  █ ████ ██ ██ █ ██  █  █   ██ ██  ██ ███ █  █ █ █  ████ ████  ██   █ █ █████     ███ █     █  ██ ██ █  ███    █ ██  ████   █  ███   █ ███ █   ██  █    ██████  ███  ██   ██ ██ ██ █   ██    █  ██ █  ███  ████        █ █   ██ ███ ██    █ █   ███   █   ██ █ ██ █ █ █  █ ██
██ ███ █ █  ███   █ █   █ █ █████   █     █  █    ██ ███     █  █ █   ██     ███   █   ██ █    █   ██ ███ ██ █ █   █   █ ██ █████ ██  ██  █        █   █  ██   █  ██  ███   █ ████ █ █ █ █ █ ██ █ █    █  ██   █   ██        █  █  █   █  █  █  ██    ██ ██ █  █ █ ██████  █ █  █      █
█  █ ██ ██ ██ ██ █ █ █  ██    ███ ████ ██  ██      ██ █ █  ██   █ █  █ ███   █     █ ██ █ █  ██ ██   █ █   ██ █████    █         ███  ██ █      █  █ ██  ██  ██ ██ █ █   █  ██  █ █  ████       ████ ███   █   █   █  ██   █  █ █ ██      █  █   █ ███    ████  █ █ ██  ██   ██ ██ █ █ █
█ █ █  █   █ █ █ █  █  █   █ ███   ██  ████ █   ███   █   ███ █      █ ██  ███ █ ██  █  █  ███ ██   █ ███   █  ███ ██ ██ ████ ███ █  ██ ██  █   ██ █  █  ██ ██ █          ██     █  █  █  █  ██ ██ █  █ █  ██ █ ██  ███  █ █  ██ █     █  █ ██ █   █  ██ ██   ██  █    █ █ ███ ███     █
████  █    ████   ██  █    ██  ██ ██   █   ██  █  █    ██ █      █    █ █   ██      ██     █     ███ ███  ██  █    █      █████              ██ █ █ ████ █  █   █  ████ █     █  ████          ██ ██   █ █        ████  █████  ██ █  █  ██ █     █  ███     ██  ██ ███   █  ██████ ██ ██
█ ██ ████ ██ █ █  ███  █ █  ██ █ ████ ███ █ █ █    ██ █ █ █ ██   █ █ ██    ██ █  █ █        █ █   █ ██ ███  ███  █   █ █████  █  █  █        ███ █        ███ ██ █   ██ █  █  █ █    █     █ █   ██  ██  █ ██  ██   █████ █ ███  █   █    █    █  █ █    █ █ ███  █ █ █ █   ██  █ ████ █
██ █   ███ ███ █ █████   █ █   █   ██    █  █  █ ███   █     █  █ ████ █    █    ████  █ █ ██  █ ███  █  █  █   █     █ ██ █ █   █ ██ █ █████ ██    ██   ██ █ █ █ █ ██ █ █ ██   ███   █    ███  █  █  ███  █  ██     ████ █ █ █ ██   ██ █    █ █ ██ █  █ █ ███ █ █   █ █ █  ███ █   █  █
███    █ ██  █  █ █     ██████   ██ █  █ ██ ████ █   █ █ █  █ ██  █  █  █ ████ █  ██ ██ █    ██ ██  ████    █   █ ████ █ █   █ ███ █  █ █  █  █  ████ ██ █   ██    ████   █  █ ████     █ █ █ ███ ██ ██  ████  █  █ █ ██   █ █ ██  █ █ ████     █ █  ████  █ ██████   █  █     ██     ██
██   █      █     █ █ ██  █   █   █ █ ██  █        ██  ███ ██ ██ ████ █    █     █ ████ █  ██ █  ████ █ ██     █ ██ ██████   █ █  ██ █   ██ ██ █    █ █    ██ ██ ██  ███ ███     █  █ █  █  ████   ███ ██ █ █ █  ███ █ █    █ █   █ ██  █ █ █   ███  █  █ █  █  █ ████ █   █    ███    █
█  █ █ █ ██ ██   ██      █ ██  █  █   ██  ███ █   █    █ ██     █ ████  █ ██ █ ██     █ █████   ██ █████     █  █  █ ██    █   ██         █ █         █ ██   █ ██ █ ██ █     ███  █  ██████  █    ██   ████    ██ ██ ██  ████  █   ███   ████   █  █ █ ██    █████    █ ███   ███ █  ███
██ ██ █  ███     ██    █ ██ ██ █ █  █    ███ ███ ████ ██   ██ █  █ █ █  ██  ██       █      █   █████   █ █ ██ █  █    █   █  ███ █████ ██   ██ ███████   ██ ██   █ █      █ ██  ███████ ██ ███ ██ █ █    █       ████ █ ███ ██ █ ████   █  █ █ █  ██  ██ ██ ███  █  ████ ██  █ ██ █ █ █
█ ███    ███ ██████   █   █         █   ███ █    █ ████  ███        █ █ ██  ██ ███ ██   ██         █  █ █ █   █  █ █  ██ ███ █       █  █ █    █ █ ██  █ ██ █  ████  █ ██    █    ██ ███ ██  ██ ████ ██ ██  █ ████ █   █  ███    █ █ █  █     ██ █    █ ██   █ █ █    ██ █ ██  █   █████
███ █  ██     ███     █    ██ ███████   █   █ █    ██  █ █████  █ █ █ █   █ █          █ █     █  ██  █    ██ █ █ █  █  ██ █ █ ████ █   ██   █ █  █   █ ███ ██ █ ███  █    █  ██████    ████   █    █  █ ████   ████  █ ██ █    █ █ █ █                █ █ ██ █      ██  █ ██  █   █   █
███ █ █  █  █  █ █  █  █     ████   █   █  ██ █ ██  ██ █  █ ██ █████   █       ██    █    █ █████  ██ ███ █ █ █  █ ██     ████ █   ███ █ █  ██  █   █ █ ██     █ ██   █████     █ █      ██ █     ██    █    █  ██████  █  █   ███   █  █ █   █  ██     █ █ █  ██ █ ███ █  ██ █ █  ██  █
█  █ █  █ ███      █    █    ██  █  █  █  ██      ██ ████ ██     █ █   █    █  █ ███  █  ███████  █ █ ██ █████   ███████   █  █ █    █ █ ██ █ █   ████   █ █ █   ██              ███ █           █   █  ██ █ █  █   ██ ██      █     █       ████████ ██   ██ █   █ █    █    █ ██  ████
█   ██ █ ██ █  ██  █ █  ███ ██  █████  █ █    ██   █ █  █ █████ █     ██    █   █ █  ███  █   █ ██    ██ ██  ███ █    █ ████ ██ █     █  █    █████  █    █  █     █ ███████  █  ██  ██    █ █  █  ██  ██  █ ████  ████ █ █  █ █    ███  ███ ██ █ █     █ ██ ████ ██  █ ██ █ █   █  ██ █
█ █    ████████    █           ██ █ ███ ██  █ ████  ██ ███ ██   ██ █  █    █ █   █  █ █ █ ███      █  ████  █ █ ███  ███  ██  ████ █    ██   █ █ ███████   █   █   █  ██ █     ██████  █   ██ ██ ███████  ██ █     ██ █     █    █     █ ██████ █  █      ███ ███ █  ██  █   █████ █  ██
███ █ ███ █         ████ ██ █    ██  ██ █  █  █   ██ ████   █ ████  ██ ██ ███████ █ █     █  ██     █        ███   ██████ █  █ ██   ███ █  █ ██ █ ██   ███  ████ █   █    ██ ███ █     █  █   ███ █  █  █  ██ █  ██ █   ███ ████ ██     █ ███ █  █  ████   ██    ██ ███ █ ███ █    ██ ██
█ █████ █ ██   ████        ████  ████   ██ ██  █   █ █ ███████ ████  ██ ████ ██  ████      █    ███     ███  █   ██ ██ █ ██   ████  █ ██   █  █ ██ █     ██  █ ████ ██ █ ██ ███ █    ██  ██ ██ █    ██  █   ██  █ █ █  █  █  █ █   ██  █ ██ ██ ███      █ █    ██    █ █   █  █   ███ ██
█    ██████   ███  █ █ █  █  █ ██  █ █  ██     ███ ██ █ ███   ██ ████ ██  █ ██  █ ███  ████ ██ █ █    █ ███ ███████ █ █  █  ███   █   █   █  █   █ █   ██ █ █ █   █  ███  ████  █        █  ██ ███ █  █ █  ██ █ █  █  ██ █  █    █      █  ██  █      █ ██ ███    ██ █  █ █      █ ██  █
█ ██ █ ███ ███  ███ █  █ █ █ █    ███ ███    █   █         ████ ███ █ ██ ██   ████ ██  █ █   ███ █ ██  █ █    ██   █████    █ █      █ █ █ ██ █ ████      █ ██  █  █       █ ██    ███  █████   ███  █ ██ █   ██   █  █             █ █ █   ██  ███  █████ ██   ██ ██ ████  █ █  ███   █
███ █       ███   █      ███    █ ███ █ █   █ █  ██       █    █ ██     █  █ ███ █ ███  █   █ █████ █ █  ██       ██ ██  ██     █  █  █ ██   ██    █ █████       █ █  ██ ██  ████   █  █   █ █    █     █    ███ █ ██ █   █ ██ █ ███ ███   █ █  █    ████ ██████  █  ██ ██ ██ █████ ██ █
█ ██  █ █   █  ██       ██    ███ ███    █   █          █████ ██ █         ██   █ ██ █ █  █ ███ █  ██  ███   █ █  █    █ ██ █ █   ██ ██ █  █ █ █   ██ ██  █ ████ ██ █ ███   ██  ██   █      █  ██    █ █ █ ██ █ ██    ██ ██ ███ ██ █  ███████ ██ ██ █   █      ███ ███ █ █     █   █████
█   ██  █  █    ████  █  ██ ██ ██ ███ █   ██    ██    ██    █ █   ██ █ █   █████ ██  █ █   █ █  █ █  █   █ ███   █ █   █ █ ███              █  ██    █     █   █ █ ████   █ ██   █        █ █ ██  █   █   ██  █ ████  █  ██     ███ █  ██   █ ██ █   ████  █ █        ███    ███████  ██
████    ██ ████ ████              █ ███   █ █ █   ██ █ █ ██ █    ██   █  █████   ██  ████ █    █     █   █   ██ █ ██ █      █ ███  █ ██ █   █  ███   ██  ██    █ ██████        ██ █  █████  █ ██ ██ ██ █    ████  ██ ██   █ █ █ █ ███ █ █    █ ██    █ █ ██ █    █ █    █ ██ █  █ █  ███
████   █ █ ██ █ ██ ████ █  ██ █   ██  ██ ████  █  ██  ██    ██   ██ █        █   █   ██ █  ██  ██    █ ██ ██ ████ ████    ██  █ █ ███    █     █  █████    ██ ██   █    █  █ █  █ ██  █  █            █   █ █ ██  █  █ ██  ███  ██   █      █ █ █  ████ ███    ███  ██ █ █ █  ██ ███   █
██ ██  ██   ███ ████  █ █     ██  ██████ ████  █ ████  ██  ███████     █ ██ ███   █ █       ██ ████  █  ██  █   ██ █  █  █        █ ██   █ ██    █  ██ █  ██  ██ █ ██  █   █ ██  █████ █      ██  █ ████████ ██    █  ██   ██   █ ███ █    ████ █ █      ███ █   █ ███    █ █    ███  ██
██ ███    █ ██  ██ █  █ ██ █   ██  ███   █ █ █     █ █  ██   █   ███ █  ██ ██ █ █ █ █          █ █    █        ██  █ ███  █  ██████    █   █  ██  █ █     █ ██     █      █ ███████ ███   █     █     ████      ██ ███  ██ ███ ██ ██ █   ████ █      ██   ██ █    █  █  ██ █ █ █ █ █  ██
██   ███ █  █   █    ██        █ █  █  █  █    █  ██   ██   █ ██  █    ██  ████        █ █ ██  ██   █   ██  █  ████ ██   █  ██    █ █ █    ██  █  █  █      ███  █ ██   █ ██ █   ███   █   █ █ █ █ █ ███    ██   █  ██       ████████ ██   ██  ██ ██ ██  █      █  ██  ██ █████    █   █
█  ██████   █ █   ██  █ ██      █  ██    ███      ██ ██ █  ███ █  █ ██ ████   █ █   █    ███  ██    ██ ████ █ ██  ██████       █   █████   ██  █  █   █  █         █ █  ████ ███ ███  █  ██ █ ██ █  ████ █  █  ████ █       █ █  █  ██ ███     █ █ █ █     █  ██  ████ ████ █ █ ██ ██  █
█ █  █    █   █  █ ██  █  █ ██  █    █ ██  ███ █ ██    ██████  ██  ███ █  ██ █   █████   ██   ███ █ ██   █ ███ ██   ████  █ █  ██  █ █  ████     █████ █ █ █     █ ████ ██         █     █      █   █ █ █ █ █  █ ███ ██  █    █ █ █ ██  ██ █  ██   ██████ █  ██  █    ████ █  █    ██  █
██  █ █████ █ ██████   ███ ██ ███  █    █  ███ ██    ███  █  █   ████  ██    ██ ██████████ █ ███ ███  ███ █ ███ █ █    ██ ███ ██    ████   ███     ██ █      ██  █  █       ██   █   ████     ██ ██    █ █ ███      █  ██   █   █ █   ██ ██ ██ █ █ █   █  █   █  ██ ██ ██ ██  █ █  ██ ██
██  ██  ████   █ █       █  ██  ██ █ █  █  █  █     ███   █             █   █  █████  ██  █  ██████    █   █ ██ ███  ██ ██████    ██   █ ██ █  █ █ ██ ████ ██  █  █      ███ █  █  █ █ ██   ██  █  █ █ █  █████████   ███ █  ██  █ █      █  ████  █  █  █ █ █   █  █    ██ █████   █  █
████████ █  ██  ██████  ██  █ █ █   █  █████ ██  █   █  ██   █   █ █ █████  █ █ █     █  ███   █  █  █  █   █ █  █  ██   █ ██ █ ████  █  █ ██      ███ ██   █ █ █   █  █    █  ███ ████ █ ███ ██ ███ █████ █████   ██    █ ██  ██      █ █████ ██ █ ██  ███ ███ ██     ███   █  █  ██ ██
█ ██   █   ███  █ █    █ █ ███  ███ █      █     █ ███ █   █  ███ ███  █   ██    █ █  ██ ████   █  ██ ██ █ █  █   ██   █ ███    █ █  █ ██ █     ████ █   █ ███ █ ██    ██  ███    ████  █ █   █ ████ ██   ██ █       █  ██   █   ██  █ █ █  ████ ███ █ ████ █  █  ████   █  ███ ██ █████
██  ███ █ █ █ █    █ ███  ███ ██ ██ █  █  ███   █  ███ █ ██  ███  █   █      █ ██ █ █  █ █ █████  █ ██  █ ██  ██ █  ███ ██ ███ ███████    ██      ███ █   ██  ███ ██  █  ██ █  █   ███ █   ████  ██ ██  ██   ███████      ███ █████ █  █ ███ █ █   █   ███ █   █ ██   █ ███        █████
█  ██    ███   █    █ ███ █  ███   ██   █  █ █  █     ██ █   █      ██   █  ███    ██   ███     ████  █ █ █   █    █ █ █ █ █  █ █ █ █  ████ █   █ ███    ███   █ █ █ █ ██       ███     ████   █ █  █ ████   █  █  ██ ███   █       ██ ██   █    █    ██      █ ██ ██  █       █    █ ██
██  ███ █  ██ █  █  ██   █   █ ████   ██ ██  █   ██  █   █    ██ ███ █  ██ █ █ ██ ██ █ █    █   █  █ █  █ ████  █ █     █  █████ █ ██         ██    ██ ██████  █ ██  ███ █  ███  ███   █  ███ ██    █████ █ ██ ██   ██ ███  ███ ██   █   █  ██                 ██  ██ ██ ██   █    █ █ █
██ ██  █ █ █  █ █ ██  █ █  █  █   ███  █ █  ██ █   █       █ █ █████ █  █  █     █   █ █ ████ █ █  █  █ █  ██ █  ██     █    █ █ █  █ ███ ██  ████ ████  ██   █ █ ██ ██ █ ██   █████ █  ██      ██ █ ███ █   █   ████  ██ █ █  ██ ██ ████ █  ██ █  █ ███ █        █ █ ███   ███ █  ██  █
█  █ █   ██    █   ██     ██   ██ ███████   ███   ███ █ ███  █  ██  █ ██    █  ███  █   █    █  █  ██  █████ █     █████  █   █ █ █ ██ █ ████  ██ ████  █   ████   █ █ █ █           █      █ ████ █     █    █ ██  █   █ █  ██  ██  █ █  ███  █  ██ ██     █   █ ██        ██ █     █ █
██ █ ██ █    █ ███  █   ████  █  █ ███  ███      ████ █   ███ ███       ██   ████ █ █  █      █  ████     █ ██████ ███  ██     █  █ █ ███ █     █  ██ █ █ █ ████  █ █ █  █ █ █    ███ ███ █     █  █    ███  ███ ██ ██  ██ ███ ██      █   █  █  ███  █  ███     █  ██   ██ █ ███      █
████████████████████████████████████████████████████████████████████████████████████████████████████████████████████████████████████████████████████████████████████████████████████████████████████████████████████████████████████████████████████████████████████████████████████████
