████████████████████████████████████████████████████████████████████████████████████████████████████████████████████████████████████████████████████████████████████████████████████████████████████████████████████████████████████████████████████████████████████████████████████████
███   ███ ███  ██   █  █  ██       ██████ ██ █       █  █     █ ██ ██ █ █  ██ █ ███     ██  ███ █ █  ███   █  █  ██  ██ █  ███ ███ ██ ██       █  ██ ██████ █     █ ████ █ █ █   ██ ████ █ █     █     █     █     █  ██ █   ██ █   ████ █      █ █   ██     █       ███    █ ███  █████
█ █ ███  █   ██ ███ █ ██  █ █  ██ ███ █ █ █ ████  █ ██   █ ███ ████ █  █ █ ██ █   ██ █   ██ ██  █ █ ██         ███  █  █ ██  █ ███    █  █  █  █  █  ██  █ ██ ███ █  ███ █ █  ████  █   █ ██  ███ ██ █       ██                ██ █  ██ █  █    █ █ █  ██ █  █ ██    ███ █ █████  ██  ██
█  ███  ██ █████ █  ██ █ ████      █  ██  █      ███    ██ ███  █  █     ██ █████  █  ████  █ █    ██  █ █    ██ ████ █ █ ███ █ ████  ███████ █ █████████   █ █ ███  ███████  █ █████  █   █ ██████   █ █   ██  ██   ███      █  █ ███  █   █  ███ █ █ ████ █  █ █ █  █   █ ██  █  ██  █
█  █ █  █  █  █ █ █  ███  █ █████   ██ █   ████  ███  █  ██ ████  ████ █ ████ █  ██ █ █ █   █  ██   ███ ██ ████ █████       █    █    █   ██ █ █ █ ██ █  █ ██  █    █ █ █ █   █ ██████   █ █     ███  ██  ██ █   █  █   █   ███   █    █████████  ██  ██  █ █    █ █ █  ██  █     █   ██
██ █ █ ██   █  █   █ █ ██████  ██ ███ ██ ██ █      ████    █   ██   █  ████ █ ██ ███   █  █ █ █  █ ███ █   █   ██ █   ██   ██ ██   █  █ █ ██ ███  ████ ██████  █ █   █ ███  ██    █ █    █  ████  ███ ███ █    █ █ █      █  █ ██        ███ ███   ███  █   █   ███   █ ██    ███ █ █ ██
████  █ █  █ ███  █    █  ██ █ ███ █   ███      █  ██ ███   █  ██    ██  ██ █ █ ██ ██ ██ █████      ███    █  ████  ██  ██  █  ███    █   ███ ██ █ █ █    ██ ████   █ ██   ███     █ ██    █  ██ █ █ █ ███    ███  ███    █         █  █        █ ██ █ █   ██   █████  ██  █ █  █ █ ██ █
███  █   ██ █████ █ █ ██    ██████  █  ██       █   █ █  █   ██ ███ █ █   ██          █       █ ██ █ █    █  ███      █  █     █  █   ██ █ ████     █   █     █ ██ ██ █     █           █  █   ████  █ █   █ █ ████  ████████  ██   █ █ █ █  ██  █  ███   █      ██ ██    ██   ██ █ ██ █
█ █    ██ ██ ██ ███  █ █ ███  ██   █     █  █ ██ █  █    █ ██   ████ █   ██ █  ████ █  █ █  █  ███ ██  █  ██  █  ███ ███  █ █ █ █    ███ █ ██ █   ██  █  ██  █ █     ██ █ █  █ ██████ ██  ████  █ █   ███ ███ ██ █ ██ ██████ █    █ █  █ █  █  █   █  ██ █ ██ █ ███ ████     ██    █  ██
█     ████ ██ █████   █    ██  █  █ ██   ██  ████    █ █  █ ████ █    █      █      █ ██  █    █ █ █  █ ██ █ █████  █   █ ███  █ █   ███ █ █████   █ █   █    █████  ██ ██ ██ ███    █ █ █  █ █    ██  █  ██  █ ██    ███ █    ███    █ █  ██ ██   █ █   █    ██ ███  ███  ██ ██ ██ ██ █
██  █   █ ███ ██    █  █  ██ █████ ██ █   █  █████ ███ █      █ █  ███ █   ███████ ██ █  █ █  ██ █ ████  █████ █  █  █   █  █ ███    ███    █ █  █ ██     █    ██ ██  ██ █  ████ ███   ██ ███████████   ███ █       █  █ █ ██  █  ████ █ ██ ███   █          █  ██ █   ██ ██     █   ███
█   ███      █    █████ █        █ ██ ██ █     ███   █  █    ██ █  █     █  █████  ████████ ██ █ ██ █ █ ██████ █ ██  █  ████  ██ ██  █  ████   █ █   ███   ██   █ █  ██   █  █  ██████  █    ███     █  ██ █ ██   ██ █    █  ██ ██ █ ██ ███ ██   ███ ██ █  ██   ██    ███     █ ██   ███
█    █████    █ █████  ███ ██ █ ██ ███   ████  ███████ █ █      ████ ██  █  ███  █  █   █    ██ ██  █  ███  █   █  █ ███  █    ███   █████  █ █  █ ██ ████  ████  ██ █  █ █  ██ █ █       █ █ █     ██  █ █   █     ██    █    ███    ██ ██  █   █      █  ██     █ ███   █  █      ████
█ █  ██   ██  ███   █ █ ██ █   █   █ █ █████   █  █  █ ██ ███  ███ █  █   █  ██████ ███████ █  ███      █     █      █ █  ██ ████    █ █ █ █████  ██ ███ ██    █ █ █      ███ ██ █ ███  █ █    ███  █ █  █      █ ██ █   ██ ██ ████  █  █   █ █  ██        █ █████    ██ █   ████     ██
████    █        █  █ ██   █    █  ██  █  █  █ █ █ █ ██ ██ █ █ █  ██ █  █    █ ██ ████ █     █    █ █   ██ ██   █      ██ ███ █ █     █      ██ ██ ██  █ ██ █ ███ ██  █  █     █     ██   █    █ █     █████ █ █  █   ██ ███  █ █      ███ █  █    ███     █  █ █ █ ██  █   ███ █ ██  ██
█ ████ ██ ███   █ ██ █ ██  ██████  ██ █ █  █ ████ ███ █   ██   █ █ ██  █   █  ██ ██ ██ ██ ███        █ █ █  █  █ █ ███  █ ███   █   █   █  █ ███  ████ ██   █  ██   █  ████   █    ██   █    ██ █ █ ██         █ █ █   ██ ███ █ █████   █ ███ █  █ █  █ ██    █ ███   █ █  █   ██ ██  ██
█ █  ███ █         ██ ███  ██        ██ █████ █ █ █ █  █████  ██ █    █   █ ███ ██  ██  █  █  █ █ ██    ████   █ █   █ █ ██ ██████  █ ██ █   ███   █  █  █    ████ ████ █  ██ █████  █ ██  █ █████   ██ █  █  ███ ██ █        ██ █ ██   █       ██   ██ █       █  ███      █ █  ██ ██ █
███  ██    █ ███ ██  ██  █████  █ █    █  █  █ ██  █ ██  █ █ ███████ █ ██    ██ ██ ██ █ ████ ███ █    █ █ █ █ █   █  █ ██ █████   ███   █    █ ██  ██ ███   █   █   █ ███  █     █ ██ ██ █   █ █    █ █  █  ███ ██ ███ ██  ██ █  ████ ██  █  █    ███   █    █   █ █  ███ █     █ ████ █
███ █      ███ ███      ██     ███ █ █    ███  █  █   █    ██ ██    █    ██   █ █  ██  ███    ██  ██  █  █     █  █  █  █   █ ██   █ ████    ██ ███  ███ █    █  █   █ █  █ ██   █ ███ █ █ █  ██ █ █        ██  ████ █   █ ██    █  █████  █ █ █ ██ █   █    █  ██  █  ██ ████  ██  ██ █
█   ██ █     █ █ ███  █ █ ██ ████ ███ █ █   █  ████    █   █ ████ ██ ██ █  ████ █ █ ███  █    ███████ █     ███  █   █     █ ██    █ █   █ ██ ██   ███  █  ███   █   █   █  ██ █     █  █ ███ ██ ██ ██ ██  ███  █ █ █  █   █     █ ██ ██  ███ █    ██      ███ █  █         █ █ █ █  █ █
█  █ ██  ████     ██         █ ██ ██ █    █   ██  ██ █ █████ █ ██  █    ██████ ██    █    █  ██      ██  █ █  █ █████ █████  █        ███  █ █ █ ███  █   █ ███ ███ ██         ███    █  █ █ █ ██    ████   ██ ██   ██     █      █    █ █   █     █   █ ██ █     █ █  █   █ █   ████ ██
██   █     █    ████  █ █  ████  ████ ███  ███    ██ █ █ ███  █   █    █ █ █  ██ ██ █   █ █ █    ██ █ █ █          █ ██   ██ ██  ██     █ █  ███ █       █    █   ██  ██ █ █ █ █ ███ ██     █   █ ███ █   █ █    ███   ██ ██  █ █ █   █    ██ █   █ █ █  █ ██  █  ██  █   █   █ █  █ ███
███  ████  ██  █  ██  █ ██      █ ██  █   ███ ███  █ ████ ██ ████     █   █ █    ██████ ███ ███    ██     █ ██   █  ██  ██ █ ████    ██    ██ █   ███  ██ ██  ████    ██ ████  ██      ██ █     █ ███ █  █  ███  █ ██ █  █   █  █  ██ ██ █ ███     █ █ █  █ ██████ ██   ██ ██   █ █   ██
███  ████ ███ █  █    ███ ██ █ █  ██  █ █   █ █     █   █ ███ █ █     █   █████ █ █     █ █  ██ ██  █ █  ██ ██ █ █  █  ███   ██ █  █    ██    ██    █  ███ ████  ████ █ █   ██  ██   ████   █ █   █ ██ █         █ ██    █ █    ████ ██ █ ███ █ ██   █    █ ██ █    █ █  █  ██  █   ████
██  █ █  █  ██   ████ █   █ █   █    ██ █████  ██   ██  █        █ █ █  █    ███ █ █ ██ ██ █      ██ ██ █ █    ██ █ █ █ █           ████  █ ██  ██ █   █ ████       █ █ ██  █ █  █ █ █ █ █     █    █   ███  ██ █  ███   █   ██  ██ █    █   █ █ █  ██ █       █  ██   █    █  ██  █  ██
██    █          ███  ██   ██  ██   █   █    ██  █ █  ███ █   ███  ██ ██   █  ███   ██   ██ █  █ █ █  █ █   ██ ████ ██ ████  ███ █  █   ██  ██  ████       █  █       ███   █ █  █ █ ███        ███     ████     █      █ ██   █████  █ █      ██ █   █  █  ██████ ██  ██ ███    ███████
███ ███  █ █ █      ██ ███      █ █ █   █ █ ██   ██ ██ ███ ████   █  █  █  █ █  █ █  █    █ █       █  █ ███    █  █    ██   █████ ██ ██     ██ ██  █ █    █   █ ██ █ █      █   ██  ██ █   ██ ████ █    ███  █    ██ █   ██ █  ██ ██ █ █  █  ███ █  ████ █ ██   █ █ █   ██  █ ██   █ ██
█  █ █  ███    █     ██  █   █  █  ██   ███      ██ █   █ █ █ ██ █   ███ █  ██ █     █ ██   ███ █  █ █    █    █  ███ █ █ ██  █ █ ███ ██    █ █ ██ ███  █ █  █ ██ █    ███  ██  █ ███ ██  ███ ██ █   █████   ██  ██   ████    ██ ████ █ ███ ████ █      ██  ██ ██ █ █   ██    ███  █ █ █
█  ████ █  █ █ █  ███   ████  █     ███  ███ ██  █  █  █ █     █ █ █ █ ██  █ █ █   ███ █ ███  █████      ██ ██   █   ██ █  ██    █  ████  █     █   ███  ████    ██ █ ███  █       █ ███████████    ███     ██ ███    ██   █ █ █  ██  ██        ██  █ █   ███ ██   ████ █  ██  █   █   █
█  ██       ██   ████  ███ ██  ███ █  █ █ ██ █   █ ███   █ █  █████ █       █  ███ █ █ █ █ █     █   █ ███  ██ █ █ ██ █████   █  █ █    ██    █   █   ██ █  █ █ █ █      ████  █  █ █  █ ██  ███     █ ███      ███    █   ██ ██ ██ █ █ █ ██   ██ ███ ███     ███ █ █   ██  ██ █ █ ██  █
██  █  ███   ██    ██   ███  █     █  █████ █ ██ ██  ████ ███ █ █ █████    █████  █   █  █     █ ███ █  ██   ██   ██ ███  ██   ████      ██   █ █ █           ███    ████   ███  ██ █  █ █   █  ██ ██ ████   █ ████ █   ███    ████    █  ███   █  ██  █   █ ██  ██    █    █ █ ██   █ █
█      ██ █ █ █  ████       █  █████ █████   █   ██ █    ██     █████  █   █  █    ███   █    █    █ █████      █ ██  █ █ █  █ █ ██  █ █ █   ██ ███ █  ██ █ █   █  ███  ██    ██      █ ██   █ ██  █████  ██ █  █████ ██   █ █ ███  █ █  █    █  ██████     ████      █  ██ ██ ███   █ █
█████ ██ ██    ██  ██    ██ █   █ █  ████  █  █ ██   █ █   █  █   ██  ███      ██    ███ ██ ██ █     █ █  ██ ███ █     █   ██ █     ██    ███ █   █ █    ██ ██ ██ █ ██ █   █  █████ █  █ █  █████ ████     █  █ █  ████ █ █ ██ █  ██ █ █ █     █ █ ██ █ █ █ █ █ █   █ ███ ███  █ █  █  █
█  ██ ██  ██ █  █    ██   █ █   ██     ████   █ █ ███  █   ██ ████ ██  █ █ █ ██ █   ██      ██  █ ███ ███ █ █ ██ █    █   ██   █  ██    █ █ █   ██ ██  █    ██      █  ██     █      █  ██   █  ███  ████       ██ █    ███ █ █ ███  ██████ ██  █  ██ █  █ █   █     █     ██   █   ████
█████ █   █ █████  █  █   █       █ ████ █  █  █     █  █   ██  █  █ █   █ █ ██ █  █     ██ ██  █     ███ ███  █ ██  █ █████ █ ████  █ █     ███   █ ██   █  ██   █ █   █  █   █ █ █  █ ██    █    █      █  █   ██   █  █ █    █ █   █  ██ ███ █ █ ███   █  █     █ ██ █     █  █   █ █
███  █  █   █ █   █    █ ██ ██  █      ████   █ █   ██  ████   █  ███    █  █     █  █ █  ██   ████ ██  ██  █ ███   █       █  █   █     █ ███  ████     ███ ███   █ ███  █  ██ ███  ███ ███     █  ███  ██    ██     █████   ██  ███       █ █ █ ████ ██ ███       █    █   █  ██    ██
█ ███   █           █████  █ ██ █  █  ███   ███ ██   █  ███ ██ ███████   █  █ █  █ █  ███   █    ██   █  █    ███████ ██████ █  █ ██ ██ █ █ █       █  █ ███ █  █    █ █ █  █  █    ███  ██ ███ █ █  █    █     ███    █ █ █         ██ █ █ █  █ █ █  █    █ ██    ███   █  █    █  █ ██
███  ██    ███ █  ██    █  █  ████ █ █       █   ██ █████  ███   ███    ██   ██  █ ██ ██  ██  █  ██  █ █ █ █   ███    █ ██ ██ █   ██ ██ ██   █ ██  █ ██ █    ██  ████  █  ████ ██ ██ █   █ █  ██  █ ██ █ █ █████ █    ███   ███ █    ██     ██ ██    ██     █   ████   █  █ █     █ ██ █
██                   █  █████  ██ ██ ██    █     ██  ██   █████ ███ ███   █ █ █ █ ███   ███  ██ ██ █ █ ██    █    █ ███ ████     █   ██ █ ██ ███ ██    █ █   ██ █ ██ █ █ █ ████ █    ███ █  ██   ███ █ ██ █     █  █ █    █ █ ██████  █  █    █  ███ █ █ ███  █ █ ██  ██     ██ ██ █ █ █
█ ██  ████  ███ ██ █    █ ██     █ ██ ██  ████  █   ███      █  █   █ ██ ██   ███  █  ██  ██ █ ██  ███   █  ██   █   ███ █ ██    █ █████ ████ █  ███  █ █    █      ██  ███  ██  █   ██ ████   █  █       ███ █ █ █  ██   █  █      █ █  █  █ █  █ ███   █  █   ██    █    ██        ███
█  █ █    ██ ███    ██ █ ███ █   ██ ███████ █  █   ██    █████    ██ ██   █   ███   █  █ ██       ████ ███ ██     █  █ ███  █  ████  ███ █  ██    █  ████  █  █ █ █ █    █ █ █ █ █ █ █  █ █   ███  █    █  █     █  █   █ ████   █  ██   ██ █  █  ███  █  ██ ██   █ █  ██  █  █ ██ █ █ █
███ █   █    █ █     ██ █    ██    █ █ █ █   ██ ██   █   ██ █ ████ ██  █ █   █  █     █    █████     ██  █  █ ██   ██ ██   ██  █  █ ███      █    ████ █ ██   ███   █  ██   ██ ████ █   █  █   █ █  █ ██   ████    █  ███   ██      ██  █ █    █  █ ██  ███  ██ ██  █  ████ █  █ ██  █ █
█  ███ ██████  ██   █ █          █  █  █ ██ █  █ █ ███ ███  ███ ██ ██ █ ██ ██  █          ██ █    ███  █   █        ███ █ █   █ █  ██ ██   ████ ██      █  ██  ███ ██     █ █   ██ █ ███ ██   █ ██   █   █   ██   █ ██ █     ██  █    █ █ ███  ███        █  ████   ███     █  ██ ███ ██
█ █ ██ ███ ██  █ ██ ██   ██ █ █████ ████ █  ██████   ███  ██ █        ██ ██   ██     █ █  █      ████████  ██  ██     ███ █  ██   █ █ ███ ██████ █   █ █  █ █    █  ██  ██    █ █ █  █ ██  █  █  █ █ █  █   ███ ██ ███   █    █   ██  █  █ ██  █ █ ██       █    ███  █     █  ███ █ █ █
█  █ █         █ ██  █ █ ██         █  ██ █   █  █ █    ██ ███   ████ ████  ██ █    █  █ █      █ ███   ██████   █ ███████████  █   █ █ █      ██ █   ██       █████   █ █    ██   ███   ██  ██  █   ██ █ █     █  ██████    █████  █ ███ ██ █ ██   █   ██ ████ █ █     █   █  █ ██ █  █
██ ████ █   █ ███ ██ █     █████  ██    █  ████ █   █    █    ██ █  █   ███ ███ ██ ██   ████ █      ███    █ █ ██ █ █   ██    █   █ ██    █   █   █     █   ██ █ █ ██ ██   █ ██  █  ██ █ ██ █   █████████   █ ██ █ █ ██ █ █  ██ ██ ███ ██  █   ████ █ ██ █   █   █ █ █       █   █ █████
█  █ █ ██ █ █ █  █ █  ██ █ ███ █ ██    ███ █ █  █  █     ███ ██████ █ ███ █ ██    █  █  █  ██ █         █ ████ █ ██ ██ █████ █ █ █     ██    ██  ███ █      █  ███ ██  ███    ██ ████         █ ██ █ █ ██ █ █    ██ █ ██ ████ ██ █████   █  █ ██   ███  ██████ ██ █ █ █  █   █  ██ █ █ █
█  ████  ████    ██    █  ██   █   █    ██ █ █    ████ ███ █   █   ███   ██ █ █      █   ████      █  ██       ██ ██  ██   ██   ██ ███ ██  ██   █   █    █ █ ██ ██ ██     ██ █    █   █        █████  ██████ █ █ █ █             ███        █ █ █ ██ ████ █   █  ████   █  █  ████ ██ ██
██    ███  █  ██  ██ █ █ █  ██  █ █ ██ ██ █  ██████  █     ██ █   █  ███ █ ████  ██ █ ██   █  ██ █  █   █  ██  █ █ ██   ████████  █ █ ███ █ ██ ██   █   ██     █  ████ ███  █  █ █ █ █  █    ██    █    █   ██   ██ █ █ █ █  █ █ █       ██ █ █    ████   ████   █    ███  ███ ██ ██   █
█  █       █  █████    █ █     █  ███████  █  █    ██████    ██ █       █  █ █ █  ██  █ ██        █ ██ ██  █ █   █ █ ███  █ █ █ ███  █ █ █ ███ ███ █   █  ██  █  █ ██ █      █ █ ██ ██ ██ █   █   ██  █ ██ ███ █  ██      █  █ █ ██ █  █       ███ ██    █  █ ██ ███  ███  █       █  ██
█    ███  ██    █ █ █  █   █ █      ██ █   ████ ███   █     ████  ██ ██ █    █  ████  ██   █      █  ███  █ █   █ ████ ███  █    ███ █    ██   █ ██   █ █   █ █   █    ██   ██ █  ██   ████  ████  ███  █ ██ █  █   █   █  ██  ██ █           █  █ ██ █   █  █ █   █ █  █ █ █   ███    █
███ ███ █  █  ██     █       ██      █     █  █ █  ███    █ █    ██ █  █  ███  █   █ ██  █ ███  █   ██ █   ████ ██    █   █ █ ██ ██ █  ██ ██   █  ████  ███  ███ █ █  ██ █ █ █ █   █   █ █   █  █ ██ ██ ██   █  █       ██████   █ ██   ███  █  ████ █ ██    ██  ███  █ █ █   ██   ██  █
█   █        ██ ██  █ █   ███ █ █████  █ ██  █ █  ██   ██   █ ██ ████ █ ██ █  ██   █  ██ █  █████  ██   █  █   █       █ █  █   ██ ██    ██   █ █ █  █ ██  █  █   █   █ █ █  █  █ █ █    ██ ██ █ ███ ███   ███   █ █ █ █  ██     █  █ █   █  █ █  █████ ████  ███ ████ █  █ ███ █  █ █ █
██ █   ██   █ █ ██ █    █  █ █   ██   █   █   █████  █ █  █  ██  ███ ██   █ █ █  ███  █  █        ██ ███ █ ███ █ █ ██  █     █  █    ██  ███ █ █  ██ ███     ████      █  █ █ █      █      █     █ █ ██  █  █  ██████   █ █  ████     █  █ █ █ █ ██  ██  ███ █   █ █  ██ █  ██  ███ ███
██  ████ ██  █   █    █ █ ██   █  ██  ███      █    █   ███  █    █ ██ █ █ █ ██      ██ ████ ███████  █    █    ██ ██ ██      ██  ██ █ █            █   ██    █      █ ███  ██ ██████ █     ███ ██  ███  █ █ ███ █  █ ██ █   █  █ █ █ ██████ ██ ██   █ █ █████   █████ ███    █  ███  ██
█    ██  █ ██   ██ █     █ █  █    █ █████     ██   █ █   █ █    ██ ███ █ ████    ██  █  ███  ███ █     █ ██   █████ ███  █  ██     █   █ █  ██ █ ████ █   █   █  █   █ █  █   █ █   ██  █ █ █ █ █  █   ██ █    █   ██ █  ████  ██   ███  █    █   ██   ██     █  █    ███   ██    ███ █
██ ███   ██  ██      █ ██       ████  ██ ████   █          ██   █ █  ███    █ ██  ██  ██  █ ██ █   ██ █      █      ████  ████  █ ████ ████ ██    ███   █████     ███    ██ █ █    █ ███ ██ ██  █ █ █  █   █    █ ██  ██  █   █ ███  █  █ ██  █   ██   █ █       █  ██ █ █    ██  █ ██ █
██     ██ █    ██ ███  █ █████    █             █  █████ ███   █   ███ █           ██    ███  █ █████ █  █  █ █  █  █████ ██ █   █       ████   ██   █    ████ ██  ██  ████████   █     ██████████  ██ █ █  █ ███   █ █   ███    ██  █ █ █ █    █   █  ██  ███    █  ██ █████    █   ███
█  ██ ███ ████████  █ █  ██  █████ ██   █ ███    █ █     █  █   ██  █     █  █     █  ███ ██ █ ██ █ ██   █ ██ █          ███   ███ ██        █   ██ █ █ ████ ██   ██   ███ ██ █   █        █      █  █ ██     █ █ █ █ █ █ █ █ █   █ ██    █  █ █ █ ███     █ ██   ██       █ █ █ ██   ██
█ ██  ████ █ ███ ██ █ █   ██  █    ██   █ █  ██ ███       ███ ████    ███ █  ███ █  █   █ ███ █  ███  ██   █  ██    ███  █  ██        █ ██ ███ ███  ███ █ █   █        █ █  █     █  ███ █ █  ██ ██  ██  █ █  █   ██   ███ ████ ██  █  ████ █  █████ █  █  █   ██  █ █    ████   █  ████
█  ██   █ █  █  ██ ██ ███  █  █   █   ███  █     ███   ██████      ██    █ ███ █ █    █ █ █ ██ █ █  ██     ████ ██ ██   ██       █  ██  █ ██     ██  █ ██   █ █ █   █ ██   █ ████ █        █ █  ███  ███ █ █ █ █ ██   ███   ██  ███ █   █ █ ███ ███ █ █  ██ █ █    █    █   ███ ███   ██
█ █ █      █ █ █ ██  █ █  ██   █ ██ █     ██    ██ ██ ███ █████   ██    ██    ████ ██  █     ████ ██  ██  █  ████ █  ██ ██ █ █ █ ██         ██  █   █   █ ██ ███  ██ █   ████     ██ ████   █ █  █ ██  ██   █ ██   █   ██ ██      ██ █  ███   █ █  █ ████        ███████     ██        █
██   ████      ██ █ █████  █ █    █  ███   █  ███          █ ████ ██  ███     █    █ █ █   █  █ █   ███   █ ██     ██  ███     ███ █    █  █  ██  █  ██ ██  █ █      ██ ████  ████   █   █         █  ██ █████    ███        █  █   █   █    ██ █ █  ███  ███ █  █     ██ █  ██ █  █  ██
██ █     █ ████  ██ ███ ██  █  █ █  █    ██ ██  ███ █         ███    ████ ██    ██  █   █  ██  ███  █    █ █ ██ █      █    █  ██ ███ █  █             ███ █ █  ██ █ ██     █ █  █  █ █ ██  ███ █ ████  ██ █████   █ █████      ██  █   █ ██  ██ █  ██  ██ █   █ ██   █    ██    ███████
███  ███ █  █ █  ███  █   ██ █     █ █    ███    ████ █ ██  █   █ ██ █   █  █  ██   █    █ █████   ███          █    ██  ███  █ ██    ██  █   ██ ██ █         █  █ █  ██  █ ███  █ █████ █ ████  ██  █    █   ███       ███ ██ █ ██       █  █   ██ █     █ █  █ ██ ████ █ █       █ █ █
█   ██ █  █ ████    █   █ █ ██ ████        █ █      █  █ █   ██    █  ████  █      █       █ ████     █   █ ██    ███  █████  █ █    █ █ █ ██   █  █ █  █  █ ████  █ ██ ██       █ █  █     █ █   █ █ █   █████ ██ █  ██ ███ █  ███ ██ █     ██ ██    ██   █ ██ █ ██ █  █   █ ██ █ █   █
██  ██  █  █         █ █ ██    █ ██ ██  ██  █ ██ █ █ █   ██ ████ █       █  ██     ██████ █ ███           ██ █  ████ ██ █ █ █  ██   █████      █  █ █    █ █   █  ██ █   ██   ██  ██   ███ ████  █ █    █   █  █ █ █ ██    ██  █   ██ █  ██ ██ █ ██ ███ █   ███  █ ██████ █ █ █ ██  ██ █
████████████████████████████████████████████████████████████████████████████████████████████████████████████████████████████████████████████████████████████████████████████████████████████████████████████████████████████████████████████████████████████████████████████████████████
