████████████████████████████████████████████████████████████████████████████████████████████████████████████████████████████████████████████████████████████████████████████████████████████████████████████████████████████████████████████████████████████████████████████████████████
███  █ ██   ███ ██   ██      █   █ █ █ █ ███████ ████   █   ██     █  █ ███  █ █ █ █ █  █████      ██    █    █ █        █ █   █     █ █     ██████ █  █  █ █ ██ ███ ██   ██ █   ████    █     █ █   █  █    █  ███     █ ████  ██ █ ████  ██  █ ██ █ ██    ███   █ █ █   █ █  █  █ █ ██
████   █ ███  █ █     █   ██  ███  ██ █  █ █  █  █ █ ██ █  █ ██ ███  █ ███ █ █    █ ██ █ ███ █ ██ █  ██ █   █  █   ████   █  █ ██ █   █ █ ██  ████  ██ █     █   █ █████  █   █  █  ██   █ ██ █ █  █ ██ ████  █     █  ███ █    █  ███  █   █  █ █   █  █   ██    ██  █   █ ██ ██    ███
█ █ █  █ ██ ██ █  █  ██   ████ ██ ███   █         █ █  █ █   ██       ██  █  ███  █     ████ ███ ███  █ ███ ██ ██       █   █  █    ████ █  ██   █ █           █ █ █ ██ ███ ██ ███  █  █  ██   █ ███ ███      ██   ████  █   █  ███   ██ █  █ ██ █ █ ███ ███   ██ █  ████  █  ██   ██  █
█    ██   █    █ █ █ ██   █ █ ██ █ █ █ ██ ███ █ █ ███ ██    █   ██ ████ █ ██   ██    █  ███ ███ ██ ██ ███ █  █  █ █   ███ ██ ██    ███  █  ██ █    ███ █ ██ ██   █   █ ██  █   █ █  █    █   █   █████   ████ █ ██ █   ██  █  █     █ ██ ██  █    █████ ██    ██ █   █  █████ █      ███
██ ██ ███ █ █ ███  ███    ██  █   █    █ █ █ ████ ██ █ █     ██  █  █   █   ██   █  █     █ █  █    ██   █  █  █  ██ ███████   ██  █ █ ██████ ███  █████ █    ██  █       ██ █        █      █ █  ██████  ██ ███   █  █   █ █  ██ █ █ █   █ █ █     █ ███ █      █   █  █  █           █
████ █    █  █  ███    ███████ █ █ █          █ █  █    ██████  █  █ ███  █ ██         █ ██ █   ██   █  ██ ██  ██   █ █ █████      █  █       █  ██   █  ██ █      ██     ██  █ ███ ██   ██ ███ █ █ █ █ ██ ███ █ █  ████   ██  ██  ██       █ █ ███ █ ██  ███ ███ █   ██ ██    █  ███ ██
██   █ ███   █ ████   █ █   ██    ██   █    █     ██      █       ██      ██ █   █     █ ██  █  ███ ██   █    █    ███   ██ ███████ █ █ ██ █████  █  █   █  ██  █ █ ██    █ █  █     █  ██   █ █ ██  █   █   █  █ ██   ████  █ █ ██  █ ███   █ ███ ███ █ ██   █   █ █  ███        █ ██ █
█   █ █ ███  █   ██ ██  █ █     █  █ █       █ █ █   ██     ███ █  █  ██ █  █  █  ██ █ █   █ ███    █ █ █ █ █  █ ███ ██  ███  █ █████ █   ███  █       █  ██  █   █ █      ██   ███ █  █    █  ██   ████ █   ███████ █ ██ ██ █  █  █ █ ██ ██  ████   ██   ██████   █  █ ███     █  █ █ █
█ ██  █   █ ███ ███    █ ████  ███  █   █  █  █ █   ████ ██ █ █    ██ █   █ ███ ██ █        ███ █  █████    ███   ██ █ ███      █   █   █  ██  █  █ ███    █ █ ███  ██████ █████ █ █████  ███ █  █  ██      ██      ██   █ █ ████   █   ████     █ ██  █████ ███ ████   ██ █   ██ ██ █ █
███  █ █ ███   ███        █ █ █ ██    █      ██  ██   █  ████ █ █ █ █ █ ██   █  ███  █ ███  █  █ █  █ ██ ██ ██ ██ ███ ██████   █        ██   ███ █ █ █    ███  ████ █ █    ██      █      ██████  █       █    █ ██ █ █████  ██     ███ █  ██  ████  █   ███   █ █   █ █   ███ █   ██ ██
█  ███ ███ ██      █ ██ █  ██  █    ████ ██  █ █████  █   ███ █  █ █    █   █ █ ████████  ██        ███    █ ██  █  █    ██    █ ██  ██ █ ███ ██  █ █ █   ██     █  █ █████ █ ██       █ ██ █  ████   █ ████  █     █  ██    █     █  ██    ███  █    █      ████ ██   ███ █  █ ██  █  █
█  █  █ █ █ ██ █    █ █ ██  ██    █  █     █ █ █ ██ █ ██ █ █   ██  ███ █ ██ ██  █ █   █ █  █ █ █ █ ██  ██ █████ █        ███ █ ████      █  ████   █   ████ ██ ██  █ ███ █ █ ██████ █████    ██ █  ██████ ██  █  ██ ████  █    ██  █  ███  █  ███      █    █ ██  ██  ██ ███ █ █    ████
█  ██     █  █ █ █ ██ ███   █    █   █    ███ █ ███  ██ █ █  █ ██  ███ █ █ █ ██  █ ██      █ ██ ██    █  ███     █    █ █  ██       █  █ █ █ █      ██████   ███  ██ ██ █    █████  ███   ██      ██  █ ██    ██   ██  █    █ ██   █   █  ██     █ █ █             ██  ██ ██  ██     █ █
████   ██   ██ █     ████ █  █  ██ ████  █   ██████ █ ██ █         ██  █ █ █ ███████ ██ ████ █ ████ █ █ █ █ ██   █  █   █        ██      ███    █  █ ███ █ █ █  █   █  █ ███  █████      █ ███  ███ █  █ ███ █     ███ █  █    ██ █ ██ █ █  ████ ██      █████ ██    █        ███ █  █ █
██   ██    ██  █ ██   █ █ ██ █ █ █ █ █  ███ ██ ██ █ █  █ ████   █ █ ██ ██  █    ███ ██  ██ ███ █ ██        █  ██    █ ██  ███   █ █ █        █ ██  ██         ███   ██ ██   ██   █ ██ ████████████ ████  ███ █████ █  █      █  ██     ██   ███     ██ ██  ██ █  ███   ██ █  ██ ██   ███
█  █ ██  ███ ██  █     ██  █ █████ █ █     ██ ██  █████ █ ███████    █   █  ██      █ █   ███  █ █████ ███  █ █ █ █ █████ █ ██      ███ ██ ██ █  ███   ███  █       █   ████ █     █████   █ █████ ████████  ██    ████  ████  ██  █ █ █      █ █  ███  ████ █ ███  ██   ███████ █ ███ █
██  ██  █  ██ █ █   █     ██   █   █ █  ███   █   ██    █ █  ███ █  ██ ████   ██ █████  █ ██ ███ ██████     █ █ █ ██ █  ████ █       █   █  █  ██    ███       ███   ██ █  ██ ███ █   ██  █████ █ █  █            ██  ██ █ █    ██ █  █ ██     █  █ ██ ████   █  █  █ █ ██ █████ █████ █
█    ██ ██  █    ██    ██ █ ███   █ █       ████        █████ █ █ ██ █ █  █     █    ██ ███   ██  ████      ████ █ █    █     █   ██  ██  ██  ███  █ █  █ ███  ██     █ ███  █ █ ██     █ █  ██   █ ██ ███  ██    ██  █   █ █     █ █ ██ ████  █ █ █  ██ █ █ ███   █      █████████    █
█ ██  ████ █ █    ██  █ ██  ██ █  █  ██   ██  █ █ ████ ██████  █   █     █  ██ ██   █ █████ █   █ ██████ ████ █  ██ █ ██  █████  ██ ████  █  █ █ █ ██ ██ █     ██ █ █ █  ███   ██   ██  █ ██ ██ ██  █ ███  █  █ █   ██ █ █ ██  █  ██   ██ █ ██ █          █  █ █   █ ███ ██ ███ ██   ███
█████ █  █  █ ███ █   █ ██    █   ████         █  █ █   █  ███  ███    ███ ██     █     █  █   ██   █    ████  ██    █ █  █ █  █ █ █      █ █ ████   █     ██    █ ███  ██    █ ████ █  █  █ ██ ███ ███ ███     █ ██ █ █ █ ██ ██   █ █  █    █ ██       █     █ ██     █ ██ ████ █ █ █ █
██  █ █ █████ █ ██  █  █ █    ██       █ ██ █ ██          █    ██  ██ █ ███  █ █     ██ █ ██  █  █ ███      █      ██    █       ██  █  █   █ █ ███  █ ██   ██  ██      ██  █ ██  █ █ ██ █  █      █████      █   █   ██ █ █    █ █ ███ ███ ██ █ ███ █ █         ████   █ ██   █   █ ███
██ ████   ██  █      ██ █    █ █ █  ██    ██  ████   █ ███        ██  ███     █  █ █  █ █ █ █      █ █  █ █ ███ █ ██ █      █    █ ███ ██ ███   ██     █ █    █ █   ███   █  █ █ █ ██   █ ██  █       █      █  ███ █  ███    █   ██   █ ██  █ ██ █   ██  █ ██ ██ █  █   █ █ █ █     █ █
█ █████ █ █ █   ██ █    ██  █ █   █  █ █ ███  █   ███ █  ████ ██ █ █ █ ██ ███  ████ ██     ███  █ █ █ ██   ██   ██████       ██ █  █ █ █       ███    █ ████ █  █████      █ █   █ █  ██████████ █  █ █ █  ███████  █ █ █   ██ ██  ██ █  ███   █ █   ██ █  █  █    █ █ █ ██  █   ██  █ █
█ █   █  █    ██ █  █       █████ █ █ █ ██   █ ███ █ ███   █ █  ██  ███  ██     ███  █  █      ███ ██ ███ ███  █  ██ █████   █     █   ██ █ ██ █ █    ██    █  ██ ██ █   ███ ███    ██  ██  ██ █ █   █  █   █    ███ ██   █ ██ █    █    █  █ █ ███  █       █    █ ███ █ ██ █ ██ █  █ █
█████        █ █     ██  ██ █     ███  ███ █  █   █  █ █   ███████   ██ █ █ █       ████  ██ █ ███ ██ █ ████ ██ █ █   █ █    ██ █         █ ██ ███ █    █ █████   ██    ████ ██    █  ██  █   ████ █      █  █   ███ ██   █     █  █  ███ ██ ███   ██     ███ ██  ██ █  █         █  ███
█  █ ███    █     █  █ ███  ██ █   █   ██ ████ █ ████ ██ █    █     █  ██ █    █ █   █  █████   ███  ██ █ █ ██ █  ██ █ █ ███    █  ██  ████ █   ███████  ██       █     █ █  ██ █ ███ ██   ███   ██  █  ███  ██   █ ██ ███    ██ ███  ██ █████  ██ ██         ██   ██      █  ███ ███ ██
█ █     ██     █   █   █ █    █ ██ █ █ █   █ █ █  █ ██    ███ █ ████ ████    ██  ███  ██ █ █        █  █ ██  █  █ ██ █ ████  █ █     █ ██  ██   ████ █ █ █████    ██ ████    ██   ██ ████    ██   █     █ █ ███     ██  ██ ██   █  █   █   █ ███ █  █  █   █         █  ██ █ █ █     ███
█     █   ██   █  ███  █ █    ██████  █   █  ████   ██  ███ █   █    █  █  ██  █       █    █ █ █   █ ██ █████   █ █   █   ██ █     ██ █  █ █ █  █ ██  ██ ██  █ █  ██   █ █      █ ██ ███ █  █████  █    █    ████   █   █ █ █  ███   █ █   ███  █ ██  █    █ █ █ █ ███ █ █ █    █ █ ███
█   ████   ██      █  ██   ███  ██ █  █     █ ███  █  ██   █████  █      █      ██  █ ██  █  ██  █ ██ █      █  ██ ██  █   █   █  █   █ ████  ██   █     ██ ██      ██   ██  ███     █  █   █ ██████ ██ ███ █  █  █   █       ██   █       █ ███ █ █  █ ███     ██  █    ██  ████ ████ █
██ ██ █      █  ███  █ █   ███  ██  █  ██ █   █   █   █  ██  █     ██ ██  ███████  █  █████ ███          █  ██ █   ████   █ ██ █   █  ██   █████    █ ██    ████   ██     ██  ██    ███ █ ██  ███ ██     █ █ ██ ██████  █  ███ █ ██ ██ █ █ ████ █  █ █ █ ██ █  █  █    ██       █   █ ██
███ █  █ █ █ ████ █     █ ██ █  ██    █ █ █      █ █ █      █ ██ █   ██ █ ██ █         ████   ████      █  █ █ ████  ████    █████  ██  █  █  █  ███ ████ █   █     █ █ ████ ███  █ ██  █ ████ ██ █    █  ██   ██   █  ██ █    █ █ ██    █████ █ ██ █     █  █ ███ ███     ████     ████
█          █ ██ █ █ ████       █ ██   █   ██ █  ██  ███   ███ █ ██ ██  █      ███  ██ █████  ██   █████ █  █     █   █ ███ ██       ██ ███ ██ █ ██      ███ ████  ███████   █    █ ██  █  █  █   █ ███   █ ████    ███ ████████    █     ██  ███    ██      ███  ██   █    █   █   █ █ █
█ ██   █ █ █   ██ █ ███ ██ █     █ █ ██████ █  █  █ █     ███ █  ███ ███ ██   █  █ █ █    █   █ ████   ██ ██ █    █ ██    ██  █ █       █ ██ ██ █ ██ ████ █ ███   ██   ███ █ █  ██     ███ ██  █████ █  █ █    ███ █     █    ██     █████   █ █ █ ██ ██ ████  ██ ███ ██   ██ ██   █  ██
███    ███ █     █   ███ █  █ █ █ ████  █  ████   █ █ ██  █  █ ██  ██  █ ███ █ ██  █   █ ██     █ ███  ██████    █ █ █  █  █ █  █ ██   ██  █ █ █ ███           █    █     █ █  ████   ███      █     ██  ██      █   █ ██  ██ ██ ██  █     ██  █  █  ██      ██  ██      █  ████ ███   █
█  ████  ████  ██    █  ███  █ █ ██  █   █  █████ █ █ █ ███   ██ ███   █  █ ██  █  █   █      ██ █ ████ █  █ █ ███  █ █  ██ ██████ █   ███  ██  ██ █      █    ██   █   █ █ █ ███ █ █  █   █   ███    █ ████ █ ██ ██   █ █       █  ███   █ ████ ████ ████ ██  █ ██  ███████ █ █  ██  ██
█  ████ █ ████   ██ █ █  █   ██       █ ██      █ ██    █  ███ ███ █    █  █  █ ███ █ █  ███  ██ ███      ███ █   ██ ██ █ ████ █ █  █   █ ████ █  ████ ██ █    █    ██  ███ █████ ███ ███ █         █ █   █    █ █    ██ ███    █ █ ████ █   ██ ██   ███ █ ████ ███  █    █ █   █    █ █
█   █  █ █   ██ █ ███   ██ █  █  ██ ██   ████   ████  █  ██      █  ██ █  █ █  ██  █ █     ███    █    ██ █ █  ███  █  █    █ █    ██ █ ██  ██ █  █   ██ █     █ ██ █ ████ █ █   ██ ██ █ █ █ █  █ █   █      ██     █    █  ██ ███   █   █     █        ██ ███  █    ███   ████   █ ████
██ █ █████   ████     ██  ██ ███   █  ███ █  ██  █  ██ █ ██ ███ █    █ ██  █  █ █  █ █ █ █      █   █    ███ ████  ███   ██   ███ █  █ █ █ ███ ███   █ ██ ██       ███ █ █ ██ █   █    █     █ █ █ █ ███   █   ██  ████  ███ ██ ██  █       █ ██  ██ ████    █ █     █  █    █  ██  █  █
█ ██ ██ █ ███ █ ██   █     █   ███    █ ███  ███  █  █  █   ███ █ █   ██        ██ █    █████  █   █   █  ███  █ █   ██    █ █  █ █      ██ █ █ ██ █   █   █   █     ███ ██    ██ ███  █     █ ███  █  ███     █████ ██ █ █   █  █ ███ █      ██ █ ██    █  █ █  ██   █ ██ █        ████
█   █████  ██   █    ██     █   █  ███  ██ ███  ███████ █      █  ██  ███   █ ██ █     ██  █  █   █    ██  █ ██ █ ██       ██ █ █ ███   █        █  ███ █     █ █ ███ █  █ █  █ █ █   ███ █           ███ █       █  █ █ ██ ██ ████   ████  █   █ ██  █ █   ██  █      ██    ████ ████ █
███ █ █    █  ██████    ██     ██  ███ █ █ ██  █ ███ █     ███ █   █      █ █ ██   █ █           █ ███ █ ██    █   ██ ███   █ █  ████ █ ████   █ ███ █    █  ███ █   █  ██ ██ █ █ █  ███ ██ █  █ █████     █  ██   █ ███████    █ █ █  ███ ██ █     █    ██  ██   ██████  █ ███    █ ███
█████  █  ██ █  █  ████ ████   ██ █  █          █  █ █ █  ██    █ ██      █ █    ██ █       █  ██  █   █   █   █ ████  █        ███  ██  █ █ █        █   █   ████ █   █  █  █ ██  █  ██ █  █ ███ █ ██    █████ ██ █ █   █  ██      █  ████ █ ██ ██ █   █    █   ██    ███  █  ██████  █
██  ██   █   ██   █████  ██    ██   ███   █  ██  █ █  █    █   ███ ██    ██ ████ ██████ █ █     █ █ ████ ██    █  █   █    █   █    ████  ██ █████ ██ █   █  ██ ██  █ █   ████ ██ ███    ██   █  █   █  █ █  █ ███ █████  █  █ ███ ███ █  ██  █  ███ █ ██        █ █ ███  ██ ██  █ █ █ █
█  █ █       ███  ██ ██   ██  █    █ █  █████ █ █ ████ █      █ ██     ██  █ ██ ███   █  ██  █   █ ██   █   ████    █ ██     █   ██  ███    █ █  ██  █     █    ███ ██    █       ███   ██ █ ██   █   █   ██ █   ██  ████  ██   ███ █ █ █  █   ███ █ ██      ███ █ ███ ███   ██    █   █
███      █ █  █  ██   ██  █  █ ██ █     █ █ █ █  █ ██ ██   ███ ██   ██ █ ███  █  █         █   █ ██ █   ███ █      ██      █ ██  ████   ██ ██ █ ██ █ ███ █ █ ██  ███ █     ██ █ ███   █   █ ██    ████ ██  █ █ █ █ ██ █  ██  █   ███  █   ██  █ █ ██ █   ████  ██████ ████     █  █ █  █
██ ██ ██   ███ █ █ ██   ███  █      █  ██ █ █ █ █       █  █  █ █   █     ██   █  ███     ██ █ █      █ █ █ █ ██  █ ███  █   █    ███ █ █ █ █  █   ██  ██      ███ ██   █  █   █  █   █ █   █ █        █ █ ███ █ ███ █ ██ ███ ██     █ ██ ██ █    ██   █ ███ ██  ██ █  █ ██  █ █ █ ███ █
██ ███ █     ████  ██  █ █  █████ ██████ ██   ██ ██     ███ ████ █    █   █ █    ██     █  ██  █  █ █ ████    █    █ ██    █ ██ ███ █    ███      █   █    ██  █  █ █  █ █     █ █ ███ ████ █ █ █ █   █ █ █ ██ █     █ █ ████ ██   █  ███ ██  ██ █ █ █     █ █  █  ███  ████ █ ███  █  █
█████   █  ███ ████   ██     ███  █   ██  ███   █████          ██ █ █ █    ██ █ █ ████  █ █  █  █   ████ █  █  █  █    █  ███ █ █ █   ███   █    █ ██  ██ █   ███ █ █  █ █   █  ██  █  ████ █    █ ███     ██  █ ████ ████ █ █ ███  █  █ ██  █ █ █ █     ████            █  ██ █ ███ █ █
█   ███  █ █ ████  ██ █    ██  ███  █   █      ██  ███   ███    █ ███ ███ █ █████ █ ██ █      █ █ █████  █    █  ██ █   █ █        ███ █  █ ██  ███ █ █  █ ███ █ █ ██ ████  ████   ██ ██ █████   █ █████    ██   █    █    ██ █ █     █  █  ██ ██  █  █ █  ██  ████ ██  █  █  ███ █ █ ██
██    ██ █ ██ █     █   ██  ███   █  █ ██  ██ █  █  █ █ █   █ █ ██  ██ ██ ██ █  ██ █  █ █       █   ███ ███  █  █ █    ██ █ █   ██ ███ █ ██   ██  █  █  █ █ ██ █   █ █  █ █  ██ █    █  ██  ██  █ ██ ███ █  █  █ █ ██  █ █ ██       █ ███    ██   █   ██ █       ███ ███  ██  █ ██ █ █ █
█  ████ █            █  █████ ██ █ ██   ████ █ ██  ███ █████  ██  ███    █    ██ █   ██  █  ██    ██     ███      ███ █ █  █ ███  ██     ██ █ ██ ██   ████  █ █  █   █ ████ █  █ █ ███     █  ████  ███ █  ████ █    █ █        █ ███     █    █    █   █  ███    █   ██ █    ███ ████ █
█    ███ ██  █   █ █ █ █ ███  ██        █   █   ██ ███ ██     ██ █  ██ ███ █ ███      ██  ███   █ █  █  █ █  █  █ ██ ██ █   ████   ███  █     ███ ███ ████ █      ██  █ ███   █     ██  ████ █   █ ██  █ █  █ █ ██       ████ █   █        █    ███ █ ██    ██  █ █      ██       ██   █
█ █ █  ████      █████    ██  █  ██ █  ████ █  █ █  █   █  ██    █  █████ █  ██     █ █   █ ██ █ █  █ ██     █ █ ███  ██  █ █ ███ ██ █   █ █ █  ██ █ █     █  █       ████   ███ █  █ █  █    █  ███████ █ █ ██████      █    ██ ████ █ █ █ █ █     █  █████  █  █  █ █ █ █████ █    ███
█  ██  █     ████    █ █ █  █     ██   ████ █ ██   █  ██ ███ ████ █  █████████ ████  █ ██ █ █  █ █ █     █ █████      █ █       ██  █ ███ █ █  █ ███ █   ██   █  █      ██ █   █ ███████   █  █ ████ ██  █   ███████ ██████ ███   █ ██ ██  █   █     ███ ████ █   █ █ ████  █   ██   █ █
██ █ ██ ███ █   █  █       █  ██    █ █     ██  █ ██  ██ █ ██ █ █  █ ██ █ █  █  █  █   █ █ ██   █   █ █ ██ █ ██      ███ █   ██    ██████ ██  █  ██  ███    █ ███  ██ █   █ █    █  ███  ████ █ ███ █   ██ █  █████     █  █       █  ██  █ █  █  █     █ █  █ █ ██  █ ██ █ ██ ███  █  █
█ █ ███ ████ ██ ██ █  ████  █ ████ █ █    ██ █   █ █ █ █   ██ █      ██ █   ███  ███  █  █ █  ████ █  ██ ██ █     █ ██  ████  ███ █ █ ██  ██ █   █  █  ██ █ ███   █ ██  █ ███   ███     █ ██  █ █   ██ █  █ █  █  █ █ ███  ██   ███ █  ██ █ █  █ ██ █ ██   ██  ██    ██ █  ███ █      ██
██ █ ██  █ █ █ █ ██ █     █   █ ██ ███ █████ █    █  ██    █  ██ █    █    █ █ ██ █   ███ █   █   █ ████  ███   ████  █   █ █  █ ██   █ █   █ █  ██ ███ ████ █ █ ██  █████ ██  █  █    █ █     ██ █ ██ ██ ██    ██ █    █  █ █ ██ ███  █  ██  █ ██     ██   ███ █ █   █ █ ██ ██    ██ ██
██  ███     ███   ████ █ ███  █  ██      █ █  ████ █████████ ██  █     ████ █ ██  ███  █  █ █    ██  █  ██ █  █   ██  ██     ██     ███ █  █   █  █ █  ███  ██  ██   █  ███ █   ███   ██ ███ ███    █  ███       ██  █ █ █ ███  █     █  █ ████ ███████ █  █ ██ █   ███████    ██  █ ███
██  █████  █      █ █ █ ██ ██   ███  ██   ██    █ █   █ ██   ██ █   █  █████  █     ██   ███     █ █ ███ █ ██    ███ █ █ ███ █████       █ █ █ ██  █   ██    █   █   █         ███  █ ███        ███  █    ████ █     █ █ ███   ███   █   █ ███ █  █        ██  ██ ███    █ █ ██ █ █ ███
███   █ ████    ███ █   █      ██   ██   █ ██ ██   █  ██     █  █   ██ ██  █████    ██ █   █  ██ █    █ █   █ ██   █ █ █  ███    █ █   █ █   █   ████     █ █   █     ██  █ █    █ ███      █   ███ █ ██ █ █     █ ██████████  █ █ █ █    ████ ███    █        █  ██  ██    █ █  █  ████
██   ██   ██ ██        █  █    █ ███  █    █   ███   █   ██  █ ██ █ █    █  █ ██ ██  ██ ██ ████  ██ █    █ █    █ ███  █ ██       ██  ██ ██ █    █     ███     █    ██    ██████ ██  █ █  █    ██ ██  ██  █ ██ █   █ ████    █ █ █   ██     ███  ████ █ █  ███ ██  ██    ████ ██ ██  ███
████ █       █ ███ ██  ██   █ █ ████      ██ ████    █ █  █ █  █ ██   █     ██ █  ██      ██  █   ██ ██  ████ █   ██ █ ██  █ ███  █   █   █ ███    ███ ██ █ ██   ███  █  ██ █ █ █ █ █ ███ ██   ██ █ ████   ███  ███   █    █  ██  █ ███ ██    █           ██  ██     ██ █  █  █████ ██ █
█ █ █     █     ███████   █████ █   █ █████ █    ██ █ ██  █ ██ █       █ █   ██  ██████ █  █ █ █    █  ██   ███  ██ ██     █   █ █   █   ██    █ ██ █ ███ █   █ ███ █      █ █  ██ ███ ██   █ █     ██  █ █  ███ █  █     ███ █ █   █  ██ █ ██ █  █ ██      █  ████     ██ ██  █  █ █  █
███ ████████ ███ ███   ██  █  ███ █    █ ██ ████  ██   █  █  ██       █  ██      █ ██ █████ ██  ██  █ █   ████  ██  ██  ██ ███ █   █   █ █   █ █      █   ██ ██  █ █ █  ██  █ █   ██   ██   ██   █    █ ██  ██ █    █ ██  ██        █ █ █  █  █ ███  ██ ██  █     █ █ █  █ █  ████ █  ██
█     ███ █ ████ █ █  █ █  ██  █  ███   ██    ██ █  ████   ███ █  ██  ████   █   ██ █ █ ██    █ █ █  █   █  █    █ █ ██ ███ ███   █   █ █ ████  █  ██ ███   ████ █  ██ ██  █  ███   █  ██  ███ █   █████ █ █ ███  █ ██ ██ █   █ █   ██  █  █ ██  █  █  ██  █  ██     ████ █   █    █  ██
█████      ████ ███     ██  █ ███ ███   █ █  ██   ██ █  █   █ █  █████ ███   █   █ █   █  ██  ███                     █ █ ███   ██  ████  ██ ██████    █   █   █ ██  ███ █ █   ██   █  █   █ █ ████   █   ██ ███ █ █ █ █  ███ █████   ██     ███ ███  █ █  █  █   █ ████ █████   █  █  █
████████████████████████████████████████████████████████████████████████████████████████████████████████████████████████████████████████████████████████████████████████████████████████████████████████████████████████████████████████████████████████████████████████████████████████
