███████████████████████████████████████████████ ████████████
████████████████████████   ███████████████████   ███████████
████████████  ███████        ██████   ████████      ████████
███  ██        ████            ███    ████████        ██████
██                                    ███               ████
██                                   ███                 ███
██                                   ███                  ██
██                                   ██            ██     ██
██                                                ████    ██
██           ███      ██                          ████    ██
██          █████    ████                         ████    ██
██           ████    ████                  ██      ███    ██
██            ███    ███         █       █████            ██
██             ██     █         █████████████             ██
██                               ████████████             ██
█                                 ██████████              ██
                                     █████       ██████  ███
 ████                                 ██        ████████████
████████                                       ████████  ███
█████████                   ██                ████████    ██
█████████                  ███               █████████    ██
████████                    █                ███  ███     ██
████████                                     ██           ██
█████████                                   ███           ██
█████████████                            █████            ██
████    ██████                     ██   █████             ██
███       ██████████████                █████             ██
██         █████████████                 ███             ███
██          ██████████                                 █████
██           ████████                        ██       ██████
███           ██████                       ████       ██████
███████        █████          ███ ██      █████      ███████
████████         ██      █   █████        ████       ███████
██████████              ███  ████          ███       ███████
███████████             ██   ████           ██       ███████
███████████            ███    ██            ██       ███████
██████████             ████   ██      ███  ███      ████  ██
██████                 ████   ██     █████████     ████   ██
███            ██       ██           █████████    █████   ██
██            ████                   ████████     █████   ██
█             ████                    ██████      █████  ███
█              ██                      █████      ████   ███
██                                      ████      ███    ███
███                            ███       ███    █████    ███
███                 ██         ███             ██████    ███
███                ████                        ██████    ███
████              ███████                      █████     ███
████      ███     ████████                      ███       ██
███      █████        █████                     ███        █
███   ████████         ████                     ████        
██   ██████████        ███                       ███      ██
██     █████████      ███                        ███     ███
███      ████████      █                         ██      ███
███        ███████                              ███      ███
███        ████████                              █       ███
███        █████████   ██                                ███
████      █████████████████                             ████
█████    ███████████████████████               ██      █████
█████████████████████████████████   ████████████████████████
██████████████████████████████████ █████████████████████████
